could your yaks read ? QUEST	your yaks could read . QUEST	could
could some cats laugh ? QUEST	some cats could laugh . QUEST	could
would my bird read ? QUEST	my bird would read . QUEST	would
would the rabbits smile ? QUEST	the rabbits would smile . QUEST	would
could your seal sleep ? QUEST	your seal could sleep . QUEST	could
can some seal sleep ? QUEST	some seal can sleep . QUEST	can
would our birds live ? QUEST	our birds would live . QUEST	would
would some unicorns read ? QUEST	some unicorns would read . QUEST	would
can her cats sleep ? QUEST	her cats can sleep . QUEST	can
will her bird read ? QUEST	her bird will read . QUEST	will
could my unicorns read ? QUEST	my unicorns could read . QUEST	could
can your monkeys live ? QUEST	your monkeys can live . QUEST	can
could your monkeys giggle ? QUEST	your monkeys could giggle . QUEST	could
will some cat read ? QUEST	some cat will read . QUEST	will
can our bird sleep ? QUEST	our bird can sleep . QUEST	can
would my cat smile ? QUEST	my cat would smile . QUEST	would
can the dog smile ? QUEST	the dog can smile . QUEST	can
would your seal sleep ? QUEST	your seal would sleep . QUEST	would
would her monkeys sleep ? QUEST	her monkeys would sleep . QUEST	would
would our seals sleep ? QUEST	our seals would sleep . QUEST	would
would the rabbit giggle ? QUEST	the rabbit would giggle . QUEST	would
could the seal live ? QUEST	the seal could live . QUEST	could
will the unicorns live ? QUEST	the unicorns will live . QUEST	will
can some unicorn live ? QUEST	some unicorn can live . QUEST	can
will our rabbit live ? QUEST	our rabbit will live . QUEST	will
will her unicorn live ? QUEST	her unicorn will live . QUEST	will
would some bird laugh ? QUEST	some bird would laugh . QUEST	would
will your elephant read ? QUEST	your elephant will read . QUEST	will
can the yaks sleep ? QUEST	the yaks can sleep . QUEST	can
would my monkeys smile ? QUEST	my monkeys would smile . QUEST	would
can my cats read ? QUEST	my cats can read . QUEST	can
will our dog giggle ? QUEST	our dog will giggle . QUEST	will
will our dog sleep ? QUEST	our dog will sleep . QUEST	will
can her monkeys sleep ? QUEST	her monkeys can sleep . QUEST	can
would our dog live ? QUEST	our dog would live . QUEST	would
will our seal giggle ? QUEST	our seal will giggle . QUEST	will
could the cat live ? QUEST	the cat could live . QUEST	could
would the dog smile ? QUEST	the dog would smile . QUEST	would
will the dog smile ? QUEST	the dog will smile . QUEST	will
can my monkey sleep ? QUEST	my monkey can sleep . QUEST	can
could my bird read ? QUEST	my bird could read . QUEST	could
can her yaks giggle ? QUEST	her yaks can giggle . QUEST	can
would some seals sleep ? QUEST	some seals would sleep . QUEST	would
would our dogs giggle ? QUEST	our dogs would giggle . QUEST	would
will my cats giggle ? QUEST	my cats will giggle . QUEST	will
would our unicorns smile ? QUEST	our unicorns would smile . QUEST	would
could the dog read ? QUEST	the dog could read . QUEST	could
would our monkeys read ? QUEST	our monkeys would read . QUEST	would
will some rabbits giggle ? QUEST	some rabbits will giggle . QUEST	will
will her monkeys giggle ? QUEST	her monkeys will giggle . QUEST	will
will your yaks laugh ? QUEST	your yaks will laugh . QUEST	will
can some yaks giggle ? QUEST	some yaks can giggle . QUEST	can
would your yak sleep ? QUEST	your yak would sleep . QUEST	would
will her monkeys laugh ? QUEST	her monkeys will laugh . QUEST	will
can some unicorn smile ? QUEST	some unicorn can smile . QUEST	can
will her bird laugh ? QUEST	her bird will laugh . QUEST	will
will some dogs giggle ? QUEST	some dogs will giggle . QUEST	will
will some elephant live ? QUEST	some elephant will live . QUEST	will
would our unicorn sleep ? QUEST	our unicorn would sleep . QUEST	would
will your yaks sleep ? QUEST	your yaks will sleep . QUEST	will
will your birds sleep ? QUEST	your birds will sleep . QUEST	will
could the monkey read ? QUEST	the monkey could read . QUEST	could
could some cat live ? QUEST	some cat could live . QUEST	could
would our monkeys smile ? QUEST	our monkeys would smile . QUEST	would
would the dog read ? QUEST	the dog would read . QUEST	would
would my dog sleep ? QUEST	my dog would sleep . QUEST	would
could your rabbit laugh ? QUEST	your rabbit could laugh . QUEST	could
could our rabbit laugh ? QUEST	our rabbit could laugh . QUEST	could
could my seals sleep ? QUEST	my seals could sleep . QUEST	could
would our yaks read ? QUEST	our yaks would read . QUEST	would
would her yaks read ? QUEST	her yaks would read . QUEST	would
can some yak giggle ? QUEST	some yak can giggle . QUEST	can
will the cat live ? QUEST	the cat will live . QUEST	will
would some cat live ? QUEST	some cat would live . QUEST	would
would the bird laugh ? QUEST	the bird would laugh . QUEST	would
will your seal giggle ? QUEST	your seal will giggle . QUEST	will
can the monkey giggle ? QUEST	the monkey can giggle . QUEST	can
could the seal live ? QUEST	the seal could live . QUEST	could
would some seal giggle ? QUEST	some seal would giggle . QUEST	would
would the unicorns read ? QUEST	the unicorns would read . QUEST	would
will our rabbit sleep ? QUEST	our rabbit will sleep . QUEST	will
would some seals sleep ? QUEST	some seals would sleep . QUEST	would
would some birds smile ? QUEST	some birds would smile . QUEST	would
could my rabbits smile ? QUEST	my rabbits could smile . QUEST	could
will the dog sleep ? QUEST	the dog will sleep . QUEST	will
can my rabbit sleep ? QUEST	my rabbit can sleep . QUEST	can
would your birds laugh ? QUEST	your birds would laugh . QUEST	would
could your birds smile ? QUEST	your birds could smile . QUEST	could
would her unicorn read ? QUEST	her unicorn would read . QUEST	would
can some elephant giggle ? QUEST	some elephant can giggle . QUEST	can
can our rabbit sleep ? QUEST	our rabbit can sleep . QUEST	can
could the rabbit sleep ? QUEST	the rabbit could sleep . QUEST	could
could the cat live ? QUEST	the cat could live . QUEST	could
can my rabbits read ? QUEST	my rabbits can read . QUEST	can
will her cat smile ? QUEST	her cat will smile . QUEST	will
will her rabbits smile ? QUEST	her rabbits will smile . QUEST	will
could your seals smile ? QUEST	your seals could smile . QUEST	could
could our cats sleep ? QUEST	our cats could sleep . QUEST	could
will the rabbit laugh ? QUEST	the rabbit will laugh . QUEST	will
would your unicorns smile ? QUEST	your unicorns would smile . QUEST	would
can your cats read ? QUEST	your cats can read . QUEST	can
would my rabbit giggle ? QUEST	my rabbit would giggle . QUEST	would
will some rabbit live ? QUEST	some rabbit will live . QUEST	will
will my cats laugh ? QUEST	my cats will laugh . QUEST	will
would your yaks sleep ? QUEST	your yaks would sleep . QUEST	would
would our rabbits laugh ? QUEST	our rabbits would laugh . QUEST	would
would our elephant sleep ? QUEST	our elephant would sleep . QUEST	would
would some yak live ? QUEST	some yak would live . QUEST	would
would my yaks sleep ? QUEST	my yaks would sleep . QUEST	would
could the seals read ? QUEST	the seals could read . QUEST	could
will the dogs read ? QUEST	the dogs will read . QUEST	will
can the yak read ? QUEST	the yak can read . QUEST	can
could my monkey live ? QUEST	my monkey could live . QUEST	could
can some dog sleep ? QUEST	some dog can sleep . QUEST	can
would the unicorns laugh ? QUEST	the unicorns would laugh . QUEST	would
could some dog read ? QUEST	some dog could read . QUEST	could
will my seal sleep ? QUEST	my seal will sleep . QUEST	will
will my unicorns laugh ? QUEST	my unicorns will laugh . QUEST	will
could some unicorns read ? QUEST	some unicorns could read . QUEST	could
would your birds laugh ? QUEST	your birds would laugh . QUEST	would
could your yaks laugh ? QUEST	your yaks could laugh . QUEST	could
will your birds laugh ? QUEST	your birds will laugh . QUEST	will
will her dogs laugh ? QUEST	her dogs will laugh . QUEST	will
could our dogs live ? QUEST	our dogs could live . QUEST	could
would the seal live ? QUEST	the seal would live . QUEST	would
will her unicorns smile ? QUEST	her unicorns will smile . QUEST	will
can some elephant smile ? QUEST	some elephant can smile . QUEST	can
can your rabbit read ? QUEST	your rabbit can read . QUEST	can
will your rabbit laugh ? QUEST	your rabbit will laugh . QUEST	will
would some rabbits live ? QUEST	some rabbits would live . QUEST	would
would my dogs giggle ? QUEST	my dogs would giggle . QUEST	would
will her yak smile ? QUEST	her yak will smile . QUEST	will
will your rabbit smile ? QUEST	your rabbit will smile . QUEST	will
could her monkey live ? QUEST	her monkey could live . QUEST	could
will the rabbits sleep ? QUEST	the rabbits will sleep . QUEST	will
will the dog smile ? QUEST	the dog will smile . QUEST	will
would the dog giggle ? QUEST	the dog would giggle . QUEST	would
can our yaks giggle ? QUEST	our yaks can giggle . QUEST	can
can some monkeys giggle ? QUEST	some monkeys can giggle . QUEST	can
will her cat smile ? QUEST	her cat will smile . QUEST	will
would your monkeys laugh ? QUEST	your monkeys would laugh . QUEST	would
could the monkey sleep ? QUEST	the monkey could sleep . QUEST	could
will the rabbits sleep ? QUEST	the rabbits will sleep . QUEST	will
could some monkey giggle ? QUEST	some monkey could giggle . QUEST	could
would her elephants sleep ? QUEST	her elephants would sleep . QUEST	would
will my rabbits sleep ? QUEST	my rabbits will sleep . QUEST	will
could our yaks giggle ? QUEST	our yaks could giggle . QUEST	could
can her dogs live ? QUEST	her dogs can live . QUEST	can
would our elephant smile ? QUEST	our elephant would smile . QUEST	would
could your yak smile ? QUEST	your yak could smile . QUEST	could
can her seal live ? QUEST	her seal can live . QUEST	can
could some rabbit live ? QUEST	some rabbit could live . QUEST	could
could our elephant live ? QUEST	our elephant could live . QUEST	could
can some rabbit laugh ? QUEST	some rabbit can laugh . QUEST	can
would my yaks live ? QUEST	my yaks would live . QUEST	would
would our unicorns live ? QUEST	our unicorns would live . QUEST	would
will the birds smile ? QUEST	the birds will smile . QUEST	will
will the unicorns giggle ? QUEST	the unicorns will giggle . QUEST	will
could your elephant read ? QUEST	your elephant could read . QUEST	could
will some seals giggle ? QUEST	some seals will giggle . QUEST	will
can your elephant sleep ? QUEST	your elephant can sleep . QUEST	can
will your rabbits giggle ? QUEST	your rabbits will giggle . QUEST	will
can your monkey live ? QUEST	your monkey can live . QUEST	can
could our monkey giggle ? QUEST	our monkey could giggle . QUEST	could
will our seal laugh ? QUEST	our seal will laugh . QUEST	will
will some seals giggle ? QUEST	some seals will giggle . QUEST	will
would her seals laugh ? QUEST	her seals would laugh . QUEST	would
will our yaks sleep ? QUEST	our yaks will sleep . QUEST	will
would her rabbit smile ? QUEST	her rabbit would smile . QUEST	would
could some birds read ? QUEST	some birds could read . QUEST	could
could your rabbits smile ? QUEST	your rabbits could smile . QUEST	could
can some dog giggle ? QUEST	some dog can giggle . QUEST	can
can my monkeys read ? QUEST	my monkeys can read . QUEST	can
would our seal smile ? QUEST	our seal would smile . QUEST	would
would your cats smile ? QUEST	your cats would smile . QUEST	would
can my monkeys live ? QUEST	my monkeys can live . QUEST	can
can some yak sleep ? QUEST	some yak can sleep . QUEST	can
can her seals live ? QUEST	her seals can live . QUEST	can
will the dogs smile ? QUEST	the dogs will smile . QUEST	will
will some elephants laugh ? QUEST	some elephants will laugh . QUEST	will
can your cats laugh ? QUEST	your cats can laugh . QUEST	can
can her yaks live ? QUEST	her yaks can live . QUEST	can
will your elephants laugh ? QUEST	your elephants will laugh . QUEST	will
would our elephants laugh ? QUEST	our elephants would laugh . QUEST	would
would my elephants laugh ? QUEST	my elephants would laugh . QUEST	would
can her monkey read ? QUEST	her monkey can read . QUEST	can
would some monkeys giggle ? QUEST	some monkeys would giggle . QUEST	would
would the yaks laugh ? QUEST	the yaks would laugh . QUEST	would
could my yak smile ? QUEST	my yak could smile . QUEST	could
will my yak laugh ? QUEST	my yak will laugh . QUEST	will
will some dog giggle ? QUEST	some dog will giggle . QUEST	will
will some monkey laugh ? QUEST	some monkey will laugh . QUEST	will
would her bird read ? QUEST	her bird would read . QUEST	would
would my dog laugh ? QUEST	my dog would laugh . QUEST	would
can your elephant live ? QUEST	your elephant can live . QUEST	can
will your rabbit laugh ? QUEST	your rabbit will laugh . QUEST	will
will my rabbits smile ? QUEST	my rabbits will smile . QUEST	will
could my unicorn laugh ? QUEST	my unicorn could laugh . QUEST	could
could some dog smile ? QUEST	some dog could smile . QUEST	could
can our unicorn read ? QUEST	our unicorn can read . QUEST	can
can our cats laugh ? QUEST	our cats can laugh . QUEST	can
will your cat live ? QUEST	your cat will live . QUEST	will
would the bird giggle ? QUEST	the bird would giggle . QUEST	would
will the unicorn smile ? QUEST	the unicorn will smile . QUEST	will
will my dogs smile ? QUEST	my dogs will smile . QUEST	will
will your monkeys giggle ? QUEST	your monkeys will giggle . QUEST	will
will some unicorn live ? QUEST	some unicorn will live . QUEST	will
will her unicorns read ? QUEST	her unicorns will read . QUEST	will
will your rabbit giggle ? QUEST	your rabbit will giggle . QUEST	will
can her unicorn read ? QUEST	her unicorn can read . QUEST	can
can your bird giggle ? QUEST	your bird can giggle . QUEST	can
could her seals smile ? QUEST	her seals could smile . QUEST	could
will her yaks giggle ? QUEST	her yaks will giggle . QUEST	will
would her seal giggle ? QUEST	her seal would giggle . QUEST	would
will some unicorns live ? QUEST	some unicorns will live . QUEST	will
can her elephant sleep ? QUEST	her elephant can sleep . QUEST	can
would our birds read ? QUEST	our birds would read . QUEST	would
will your elephants giggle ? QUEST	your elephants will giggle . QUEST	will
can your elephant sleep ? QUEST	your elephant can sleep . QUEST	can
will her dog laugh ? QUEST	her dog will laugh . QUEST	will
will some seals giggle ? QUEST	some seals will giggle . QUEST	will
could some monkeys live ? QUEST	some monkeys could live . QUEST	could
could some monkeys laugh ? QUEST	some monkeys could laugh . QUEST	could
will our cat read ? QUEST	our cat will read . QUEST	will
will our elephants giggle ? QUEST	our elephants will giggle . QUEST	will
would our elephant read ? QUEST	our elephant would read . QUEST	would
would some dog read ? QUEST	some dog would read . QUEST	would
would the seals smile ? QUEST	the seals would smile . QUEST	would
can our unicorn sleep ? QUEST	our unicorn can sleep . QUEST	can
would her elephant laugh ? QUEST	her elephant would laugh . QUEST	would
can my bird live ? QUEST	my bird can live . QUEST	can
will some cats smile ? QUEST	some cats will smile . QUEST	will
would the elephant live ? QUEST	the elephant would live . QUEST	would
could the bird sleep ? QUEST	the bird could sleep . QUEST	could
could some bird read ? QUEST	some bird could read . QUEST	could
will your dogs read ? QUEST	your dogs will read . QUEST	will
would some birds giggle ? QUEST	some birds would giggle . QUEST	would
would the rabbit read ? QUEST	the rabbit would read . QUEST	would
can some seal sleep ? QUEST	some seal can sleep . QUEST	can
would some dog live ? QUEST	some dog would live . QUEST	would
could my monkeys giggle ? QUEST	my monkeys could giggle . QUEST	could
will the bird live ? QUEST	the bird will live . QUEST	will
can my birds smile ? QUEST	my birds can smile . QUEST	can
can some elephants sleep ? QUEST	some elephants can sleep . QUEST	can
can some dogs giggle ? QUEST	some dogs can giggle . QUEST	can
would some dogs smile ? QUEST	some dogs would smile . QUEST	would
can some yak giggle ? QUEST	some yak can giggle . QUEST	can
will her rabbit live ? QUEST	her rabbit will live . QUEST	will
would her rabbits smile ? QUEST	her rabbits would smile . QUEST	would
would my dogs giggle ? QUEST	my dogs would giggle . QUEST	would
would some elephants read ? QUEST	some elephants would read . QUEST	would
can some yak live ? QUEST	some yak can live . QUEST	can
can the yak giggle ? QUEST	the yak can giggle . QUEST	can
can your birds read ? QUEST	your birds can read . QUEST	can
could some birds read ? QUEST	some birds could read . QUEST	could
will some rabbit laugh ? QUEST	some rabbit will laugh . QUEST	will
will our bird smile ? QUEST	our bird will smile . QUEST	will
would your rabbits sleep ? QUEST	your rabbits would sleep . QUEST	would
would her birds smile ? QUEST	her birds would smile . QUEST	would
would her monkeys laugh ? QUEST	her monkeys would laugh . QUEST	would
could our yak smile ? QUEST	our yak could smile . QUEST	could
would the elephants live ? QUEST	the elephants would live . QUEST	would
would my monkeys smile ? QUEST	my monkeys would smile . QUEST	would
will some elephants giggle ? QUEST	some elephants will giggle . QUEST	will
will her yaks laugh ? QUEST	her yaks will laugh . QUEST	will
would your seal giggle ? QUEST	your seal would giggle . QUEST	would
can my elephants sleep ? QUEST	my elephants can sleep . QUEST	can
could our yak read ? QUEST	our yak could read . QUEST	could
would our cats live ? QUEST	our cats would live . QUEST	would
can your seal laugh ? QUEST	your seal can laugh . QUEST	can
will your dogs smile ? QUEST	your dogs will smile . QUEST	will
can her yak sleep ? QUEST	her yak can sleep . QUEST	can
could your monkey live ? QUEST	your monkey could live . QUEST	could
could the unicorn read ? QUEST	the unicorn could read . QUEST	could
could the dogs sleep ? QUEST	the dogs could sleep . QUEST	could
will my yak sleep ? QUEST	my yak will sleep . QUEST	will
would the dogs giggle ? QUEST	the dogs would giggle . QUEST	would
can the unicorns live ? QUEST	the unicorns can live . QUEST	can
will the seals read ? QUEST	the seals will read . QUEST	will
would some unicorns live ? QUEST	some unicorns would live . QUEST	would
will the seal read ? QUEST	the seal will read . QUEST	will
would her unicorn giggle ? QUEST	her unicorn would giggle . QUEST	would
could her bird read ? QUEST	her bird could read . QUEST	could
can my cats laugh ? QUEST	my cats can laugh . QUEST	can
can the rabbits giggle ? QUEST	the rabbits can giggle . QUEST	can
could your unicorn giggle ? QUEST	your unicorn could giggle . QUEST	could
could her bird read ? QUEST	her bird could read . QUEST	could
would my birds sleep ? QUEST	my birds would sleep . QUEST	would
can my monkey read ? QUEST	my monkey can read . QUEST	can
can the cat sleep ? QUEST	the cat can sleep . QUEST	can
would the seal giggle ? QUEST	the seal would giggle . QUEST	would
will her elephant sleep ? QUEST	her elephant will sleep . QUEST	will
will my elephants laugh ? QUEST	my elephants will laugh . QUEST	will
can the monkey smile ? QUEST	the monkey can smile . QUEST	can
would her unicorn read ? QUEST	her unicorn would read . QUEST	would
would some yak sleep ? QUEST	some yak would sleep . QUEST	would
can our cats sleep ? QUEST	our cats can sleep . QUEST	can
can your rabbit smile ? QUEST	your rabbit can smile . QUEST	can
will her dogs sleep ? QUEST	her dogs will sleep . QUEST	will
will your seals smile ? QUEST	your seals will smile . QUEST	will
could our elephant smile ? QUEST	our elephant could smile . QUEST	could
would her dog giggle ? QUEST	her dog would giggle . QUEST	would
would her dog live ? QUEST	her dog would live . QUEST	would
will her elephants giggle ? QUEST	her elephants will giggle . QUEST	will
would our dog laugh ? QUEST	our dog would laugh . QUEST	would
will our cats laugh ? QUEST	our cats will laugh . QUEST	will
could your monkeys sleep ? QUEST	your monkeys could sleep . QUEST	could
could the seal laugh ? QUEST	the seal could laugh . QUEST	could
could your cats live ? QUEST	your cats could live . QUEST	could
can my rabbits giggle ? QUEST	my rabbits can giggle . QUEST	can
can her dog read ? QUEST	her dog can read . QUEST	can
could some cat laugh ? QUEST	some cat could laugh . QUEST	could
can the dog laugh ? QUEST	the dog can laugh . QUEST	can
can the birds giggle ? QUEST	the birds can giggle . QUEST	can
will the dogs giggle ? QUEST	the dogs will giggle . QUEST	will
will your rabbits giggle ? QUEST	your rabbits will giggle . QUEST	will
will some cats laugh ? QUEST	some cats will laugh . QUEST	will
can the rabbit giggle ? QUEST	the rabbit can giggle . QUEST	can
will my monkey laugh ? QUEST	my monkey will laugh . QUEST	will
could some yak laugh ? QUEST	some yak could laugh . QUEST	could
will my seals smile ? QUEST	my seals will smile . QUEST	will
would our yak smile ? QUEST	our yak would smile . QUEST	would
would the unicorns smile ? QUEST	the unicorns would smile . QUEST	would
would her cats laugh ? QUEST	her cats would laugh . QUEST	would
would our elephants laugh ? QUEST	our elephants would laugh . QUEST	would
could our bird giggle ? QUEST	our bird could giggle . QUEST	could
could our elephant read ? QUEST	our elephant could read . QUEST	could
could my birds laugh ? QUEST	my birds could laugh . QUEST	could
could the yak giggle ? QUEST	the yak could giggle . QUEST	could
will her dog giggle ? QUEST	her dog will giggle . QUEST	will
would my rabbit laugh ? QUEST	my rabbit would laugh . QUEST	would
will the seals laugh ? QUEST	the seals will laugh . QUEST	will
could your monkeys read ? QUEST	your monkeys could read . QUEST	could
would your monkey read ? QUEST	your monkey would read . QUEST	would
can the monkeys giggle ? QUEST	the monkeys can giggle . QUEST	can
would some unicorns sleep ? QUEST	some unicorns would sleep . QUEST	would
could my monkeys live ? QUEST	my monkeys could live . QUEST	could
will my unicorn smile ? QUEST	my unicorn will smile . QUEST	will
can the birds giggle ? QUEST	the birds can giggle . QUEST	can
will our birds giggle ? QUEST	our birds will giggle . QUEST	will
would some seals giggle ? QUEST	some seals would giggle . QUEST	would
could my cats laugh ? QUEST	my cats could laugh . QUEST	could
can our monkey laugh ? QUEST	our monkey can laugh . QUEST	can
could the yak smile ? QUEST	the yak could smile . QUEST	could
will some monkey laugh ? QUEST	some monkey will laugh . QUEST	will
can some unicorn read ? QUEST	some unicorn can read . QUEST	can
would your monkeys read ? QUEST	your monkeys would read . QUEST	would
can some unicorns sleep ? QUEST	some unicorns can sleep . QUEST	can
could her unicorns giggle ? QUEST	her unicorns could giggle . QUEST	could
will the yaks live ? QUEST	the yaks will live . QUEST	will
will my unicorn smile ? QUEST	my unicorn will smile . QUEST	will
will our unicorn sleep ? QUEST	our unicorn will sleep . QUEST	will
can her cats sleep ? QUEST	her cats can sleep . QUEST	can
will your unicorn sleep ? QUEST	your unicorn will sleep . QUEST	will
will your bird sleep ? QUEST	your bird will sleep . QUEST	will
would some unicorn smile ? QUEST	some unicorn would smile . QUEST	would
can your elephant live ? QUEST	your elephant can live . QUEST	can
will your unicorn smile ? QUEST	your unicorn will smile . QUEST	will
would the unicorns giggle ? QUEST	the unicorns would giggle . QUEST	would
would some seal read ? QUEST	some seal would read . QUEST	would
will some monkeys live ? QUEST	some monkeys will live . QUEST	will
would the unicorn sleep ? QUEST	the unicorn would sleep . QUEST	would
could her seal giggle ? QUEST	her seal could giggle . QUEST	could
will my yaks sleep ? QUEST	my yaks will sleep . QUEST	will
will our bird live ? QUEST	our bird will live . QUEST	will
would your elephants giggle ? QUEST	your elephants would giggle . QUEST	would
would your rabbits read ? QUEST	your rabbits would read . QUEST	would
would our yaks sleep ? QUEST	our yaks would sleep . QUEST	would
would your unicorn laugh ? QUEST	your unicorn would laugh . QUEST	would
will some monkey laugh ? QUEST	some monkey will laugh . QUEST	will
could her seals laugh ? QUEST	her seals could laugh . QUEST	could
will our seals live ? QUEST	our seals will live . QUEST	will
could her dogs smile ? QUEST	her dogs could smile . QUEST	could
could the elephant laugh ? QUEST	the elephant could laugh . QUEST	could
will your unicorn sleep ? QUEST	your unicorn will sleep . QUEST	will
can her monkeys giggle ? QUEST	her monkeys can giggle . QUEST	can
can her monkey smile ? QUEST	her monkey can smile . QUEST	can
can the dog sleep ? QUEST	the dog can sleep . QUEST	can
could the rabbit giggle ? QUEST	the rabbit could giggle . QUEST	could
will your yaks smile ? QUEST	your yaks will smile . QUEST	will
can her dogs laugh ? QUEST	her dogs can laugh . QUEST	can
will your unicorns live ? QUEST	your unicorns will live . QUEST	will
can her rabbits giggle ? QUEST	her rabbits can giggle . QUEST	can
will some cat live ? QUEST	some cat will live . QUEST	will
can the monkeys read ? QUEST	the monkeys can read . QUEST	can
could my rabbit read ? QUEST	my rabbit could read . QUEST	could
can your rabbit read ? QUEST	your rabbit can read . QUEST	can
could our bird read ? QUEST	our bird could read . QUEST	could
will our bird giggle ? QUEST	our bird will giggle . QUEST	will
can our seal sleep ? QUEST	our seal can sleep . QUEST	can
could some rabbit sleep ? QUEST	some rabbit could sleep . QUEST	could
could your rabbit smile ? QUEST	your rabbit could smile . QUEST	could
could our elephants smile ? QUEST	our elephants could smile . QUEST	could
could my unicorns laugh ? QUEST	my unicorns could laugh . QUEST	could
would her elephants sleep ? QUEST	her elephants would sleep . QUEST	would
would her birds sleep ? QUEST	her birds would sleep . QUEST	would
can some bird sleep ? QUEST	some bird can sleep . QUEST	can
could your cats laugh ? QUEST	your cats could laugh . QUEST	could
could our cats laugh ? QUEST	our cats could laugh . QUEST	could
can her dog sleep ? QUEST	her dog can sleep . QUEST	can
would your yaks live ? QUEST	your yaks would live . QUEST	would
would some unicorn giggle ? QUEST	some unicorn would giggle . QUEST	would
could your unicorn smile ? QUEST	your unicorn could smile . QUEST	could
could your seal read ? QUEST	your seal could read . QUEST	could
could our elephant sleep ? QUEST	our elephant could sleep . QUEST	could
could our yaks giggle ? QUEST	our yaks could giggle . QUEST	could
will some birds laugh ? QUEST	some birds will laugh . QUEST	will
will her yak smile ? QUEST	her yak will smile . QUEST	will
would our cats sleep ? QUEST	our cats would sleep . QUEST	would
would our yak sleep ? QUEST	our yak would sleep . QUEST	would
can some yak smile ? QUEST	some yak can smile . QUEST	can
could some birds laugh ? QUEST	some birds could laugh . QUEST	could
can some birds laugh ? QUEST	some birds can laugh . QUEST	can
can our bird smile ? QUEST	our bird can smile . QUEST	can
could my cat giggle ? QUEST	my cat could giggle . QUEST	could
can my monkeys giggle ? QUEST	my monkeys can giggle . QUEST	can
will your elephant live ? QUEST	your elephant will live . QUEST	will
would some bird laugh ? QUEST	some bird would laugh . QUEST	would
can her bird smile ? QUEST	her bird can smile . QUEST	can
can my birds laugh ? QUEST	my birds can laugh . QUEST	can
can the elephants read ? QUEST	the elephants can read . QUEST	can
would the yaks read ? QUEST	the yaks would read . QUEST	would
would her yaks smile ? QUEST	her yaks would smile . QUEST	would
can your yak smile ? QUEST	your yak can smile . QUEST	can
would her rabbits smile ? QUEST	her rabbits would smile . QUEST	would
can our birds smile ? QUEST	our birds can smile . QUEST	can
can some elephant live ? QUEST	some elephant can live . QUEST	can
could some yak smile ? QUEST	some yak could smile . QUEST	could
can some yak smile ? QUEST	some yak can smile . QUEST	can
will my cats live ? QUEST	my cats will live . QUEST	will
would some unicorns smile ? QUEST	some unicorns would smile . QUEST	would
would the birds live ? QUEST	the birds would live . QUEST	would
can our elephant giggle ? QUEST	our elephant can giggle . QUEST	can
can your elephant giggle ? QUEST	your elephant can giggle . QUEST	can
could our cat laugh ? QUEST	our cat could laugh . QUEST	could
can the birds read ? QUEST	the birds can read . QUEST	can
could our dog smile ? QUEST	our dog could smile . QUEST	could
can our dog read ? QUEST	our dog can read . QUEST	can
will her rabbits laugh ? QUEST	her rabbits will laugh . QUEST	will
could my unicorn sleep ? QUEST	my unicorn could sleep . QUEST	could
would some unicorn read ? QUEST	some unicorn would read . QUEST	would
could my elephant read ? QUEST	my elephant could read . QUEST	could
would our monkeys live ? QUEST	our monkeys would live . QUEST	would
will the rabbit giggle ? QUEST	the rabbit will giggle . QUEST	will
can her cats giggle ? QUEST	her cats can giggle . QUEST	can
can my birds sleep ? QUEST	my birds can sleep . QUEST	can
will the unicorn read ? QUEST	the unicorn will read . QUEST	will
could our dog smile ? QUEST	our dog could smile . QUEST	could
will some seals read ? QUEST	some seals will read . QUEST	will
will her dog sleep ? QUEST	her dog will sleep . QUEST	will
will your rabbit giggle ? QUEST	your rabbit will giggle . QUEST	will
can our elephants live ? QUEST	our elephants can live . QUEST	can
will our yak smile ? QUEST	our yak will smile . QUEST	will
would my unicorn live ? QUEST	my unicorn would live . QUEST	would
would your elephant laugh ? QUEST	your elephant would laugh . QUEST	would
could our cat laugh ? QUEST	our cat could laugh . QUEST	could
could my seals laugh ? QUEST	my seals could laugh . QUEST	could
will your dogs read ? QUEST	your dogs will read . QUEST	will
can your seal read ? QUEST	your seal can read . QUEST	can
can her seals read ? QUEST	her seals can read . QUEST	can
will her seals read ? QUEST	her seals will read . QUEST	will
can her birds laugh ? QUEST	her birds can laugh . QUEST	can
can my birds live ? QUEST	my birds can live . QUEST	can
will my birds live ? QUEST	my birds will live . QUEST	will
would her yak read ? QUEST	her yak would read . QUEST	would
would some elephant giggle ? QUEST	some elephant would giggle . QUEST	would
could her elephants giggle ? QUEST	her elephants could giggle . QUEST	could
can our yaks giggle ? QUEST	our yaks can giggle . QUEST	can
can the cat read ? QUEST	the cat can read . QUEST	can
will some elephants sleep ? QUEST	some elephants will sleep . QUEST	will
will your seals live ? QUEST	your seals will live . QUEST	will
would some elephant live ? QUEST	some elephant would live . QUEST	would
would some monkeys live ? QUEST	some monkeys would live . QUEST	would
would your yaks live ? QUEST	your yaks would live . QUEST	would
will her cat giggle ? QUEST	her cat will giggle . QUEST	will
will your cats smile ? QUEST	your cats will smile . QUEST	will
would our unicorns laugh ? QUEST	our unicorns would laugh . QUEST	would
will our unicorn read ? QUEST	our unicorn will read . QUEST	will
would some cat giggle ? QUEST	some cat would giggle . QUEST	would
could my bird read ? QUEST	my bird could read . QUEST	could
could my cat live ? QUEST	my cat could live . QUEST	could
could my monkey laugh ? QUEST	my monkey could laugh . QUEST	could
will the monkey live ? QUEST	the monkey will live . QUEST	will
could her birds giggle ? QUEST	her birds could giggle . QUEST	could
could our birds sleep ? QUEST	our birds could sleep . QUEST	could
would your cat giggle ? QUEST	your cat would giggle . QUEST	would
can our unicorns read ? QUEST	our unicorns can read . QUEST	can
can our elephant live ? QUEST	our elephant can live . QUEST	can
can some unicorns read ? QUEST	some unicorns can read . QUEST	can
can the yak laugh ? QUEST	the yak can laugh . QUEST	can
will the yaks smile ? QUEST	the yaks will smile . QUEST	will
could some elephant live ? QUEST	some elephant could live . QUEST	could
would the cat giggle ? QUEST	the cat would giggle . QUEST	would
can her unicorns live ? QUEST	her unicorns can live . QUEST	can
can our yaks live ? QUEST	our yaks can live . QUEST	can
can our seals read ? QUEST	our seals can read . QUEST	can
could the unicorn read ? QUEST	the unicorn could read . QUEST	could
can your rabbits read ? QUEST	your rabbits can read . QUEST	can
can her rabbit giggle ? QUEST	her rabbit can giggle . QUEST	can
can your seal sleep ? QUEST	your seal can sleep . QUEST	can
would the rabbit read ? QUEST	the rabbit would read . QUEST	would
will our unicorns sleep ? QUEST	our unicorns will sleep . QUEST	will
can her seals laugh ? QUEST	her seals can laugh . QUEST	can
will some elephants smile ? QUEST	some elephants will smile . QUEST	will
can your cat laugh ? QUEST	your cat can laugh . QUEST	can
will her elephant smile ? QUEST	her elephant will smile . QUEST	will
can your rabbit read ? QUEST	your rabbit can read . QUEST	can
can your yak giggle ? QUEST	your yak can giggle . QUEST	can
will the bird read ? QUEST	the bird will read . QUEST	will
could the unicorn live ? QUEST	the unicorn could live . QUEST	could
would my birds laugh ? QUEST	my birds would laugh . QUEST	would
will my monkey laugh ? QUEST	my monkey will laugh . QUEST	will
will my elephant sleep ? QUEST	my elephant will sleep . QUEST	will
can her elephants smile ? QUEST	her elephants can smile . QUEST	can
can our yaks laugh ? QUEST	our yaks can laugh . QUEST	can
would my yak smile ? QUEST	my yak would smile . QUEST	would
will our dogs sleep ? QUEST	our dogs will sleep . QUEST	will
will the seals smile ? QUEST	the seals will smile . QUEST	will
will the cat smile ? QUEST	the cat will smile . QUEST	will
would your rabbit read ? QUEST	your rabbit would read . QUEST	would
can my cats giggle ? QUEST	my cats can giggle . QUEST	can
will your elephant sleep ? QUEST	your elephant will sleep . QUEST	will
can our monkey smile ? QUEST	our monkey can smile . QUEST	can
would my yak smile ? QUEST	my yak would smile . QUEST	would
will my dogs smile ? QUEST	my dogs will smile . QUEST	will
will my seals live ? QUEST	my seals will live . QUEST	will
would some rabbit laugh ? QUEST	some rabbit would laugh . QUEST	would
could your monkeys sleep ? QUEST	your monkeys could sleep . QUEST	could
could your monkeys giggle ? QUEST	your monkeys could giggle . QUEST	could
will your yak smile ? QUEST	your yak will smile . QUEST	will
could your elephant live ? QUEST	your elephant could live . QUEST	could
will her cats giggle ? QUEST	her cats will giggle . QUEST	will
could some cats giggle ? QUEST	some cats could giggle . QUEST	could
can some yaks laugh ? QUEST	some yaks can laugh . QUEST	can
would some unicorns smile ? QUEST	some unicorns would smile . QUEST	would
would our monkeys laugh ? QUEST	our monkeys would laugh . QUEST	would
will our birds smile ? QUEST	our birds will smile . QUEST	will
could your dog laugh ? QUEST	your dog could laugh . QUEST	could
would the seal laugh ? QUEST	the seal would laugh . QUEST	would
will some birds laugh ? QUEST	some birds will laugh . QUEST	will
could my monkey read ? QUEST	my monkey could read . QUEST	could
could my dog live ? QUEST	my dog could live . QUEST	could
can your elephants sleep ? QUEST	your elephants can sleep . QUEST	can
could your birds live ? QUEST	your birds could live . QUEST	could
could our unicorns giggle ? QUEST	our unicorns could giggle . QUEST	could
can the seals read ? QUEST	the seals can read . QUEST	can
would our yaks smile ? QUEST	our yaks would smile . QUEST	would
would our yaks sleep ? QUEST	our yaks would sleep . QUEST	would
will the cats live ? QUEST	the cats will live . QUEST	will
could our seal sleep ? QUEST	our seal could sleep . QUEST	could
would some monkey giggle ? QUEST	some monkey would giggle . QUEST	would
can the yaks live ? QUEST	the yaks can live . QUEST	can
could some dogs laugh ? QUEST	some dogs could laugh . QUEST	could
could the cats smile ? QUEST	the cats could smile . QUEST	could
would some bird giggle ? QUEST	some bird would giggle . QUEST	would
can her yak read ? QUEST	her yak can read . QUEST	can
can the dog smile ? QUEST	the dog can smile . QUEST	can
can her elephants read ? QUEST	her elephants can read . QUEST	can
will my unicorns read ? QUEST	my unicorns will read . QUEST	will
can some dogs sleep ? QUEST	some dogs can sleep . QUEST	can
could our elephant smile ? QUEST	our elephant could smile . QUEST	could
can our unicorn giggle ? QUEST	our unicorn can giggle . QUEST	can
could some monkey laugh ? QUEST	some monkey could laugh . QUEST	could
would our monkey sleep ? QUEST	our monkey would sleep . QUEST	would
would our birds laugh ? QUEST	our birds would laugh . QUEST	would
will some unicorn sleep ? QUEST	some unicorn will sleep . QUEST	will
will some birds laugh ? QUEST	some birds will laugh . QUEST	will
can her bird laugh ? QUEST	her bird can laugh . QUEST	can
would her monkeys read ? QUEST	her monkeys would read . QUEST	would
will the elephants sleep ? QUEST	the elephants will sleep . QUEST	will
will the bird sleep ? QUEST	the bird will sleep . QUEST	will
would the seal laugh ? QUEST	the seal would laugh . QUEST	would
will the birds laugh ? QUEST	the birds will laugh . QUEST	will
could her dog smile ? QUEST	her dog could smile . QUEST	could
could your birds sleep ? QUEST	your birds could sleep . QUEST	could
can our unicorn live ? QUEST	our unicorn can live . QUEST	can
will your seal laugh ? QUEST	your seal will laugh . QUEST	will
can some unicorns smile ? QUEST	some unicorns can smile . QUEST	can
could the cats sleep ? QUEST	the cats could sleep . QUEST	could
can her elephants smile ? QUEST	her elephants can smile . QUEST	can
could some monkey laugh ? QUEST	some monkey could laugh . QUEST	could
would our birds smile ? QUEST	our birds would smile . QUEST	would
would your yak giggle ? QUEST	your yak would giggle . QUEST	would
would my dog giggle ? QUEST	my dog would giggle . QUEST	would
can our unicorns giggle ? QUEST	our unicorns can giggle . QUEST	can
can her seal giggle ? QUEST	her seal can giggle . QUEST	can
would some unicorn laugh ? QUEST	some unicorn would laugh . QUEST	would
would my monkeys sleep ? QUEST	my monkeys would sleep . QUEST	would
would my unicorns smile ? QUEST	my unicorns would smile . QUEST	would
can some seals sleep ? QUEST	some seals can sleep . QUEST	can
could some rabbits smile ? QUEST	some rabbits could smile . QUEST	could
can some cat laugh ? QUEST	some cat can laugh . QUEST	can
would her monkey sleep ? QUEST	her monkey would sleep . QUEST	would
would our unicorns smile ? QUEST	our unicorns would smile . QUEST	would
can our unicorn laugh ? QUEST	our unicorn can laugh . QUEST	can
can my unicorns smile ? QUEST	my unicorns can smile . QUEST	can
would the yaks read ? QUEST	the yaks would read . QUEST	would
could our monkeys sleep ? QUEST	our monkeys could sleep . QUEST	could
could my monkeys sleep ? QUEST	my monkeys could sleep . QUEST	could
will the unicorns giggle ? QUEST	the unicorns will giggle . QUEST	will
will your monkey smile ? QUEST	your monkey will smile . QUEST	will
will some unicorn laugh ? QUEST	some unicorn will laugh . QUEST	will
can your unicorns giggle ? QUEST	your unicorns can giggle . QUEST	can
will your unicorns read ? QUEST	your unicorns will read . QUEST	will
could the unicorn smile ? QUEST	the unicorn could smile . QUEST	could
could my seals read ? QUEST	my seals could read . QUEST	could
could our elephant smile ? QUEST	our elephant could smile . QUEST	could
would our rabbits laugh ? QUEST	our rabbits would laugh . QUEST	would
would your monkey giggle ? QUEST	your monkey would giggle . QUEST	would
can your monkeys live ? QUEST	your monkeys can live . QUEST	can
would my rabbit giggle ? QUEST	my rabbit would giggle . QUEST	would
would some cats read ? QUEST	some cats would read . QUEST	would
would her elephant live ? QUEST	her elephant would live . QUEST	would
will some rabbit live ? QUEST	some rabbit will live . QUEST	will
can your seals giggle ? QUEST	your seals can giggle . QUEST	can
would the monkeys read ? QUEST	the monkeys would read . QUEST	would
will my dog live ? QUEST	my dog will live . QUEST	will
can her monkey read ? QUEST	her monkey can read . QUEST	can
can our rabbit giggle ? QUEST	our rabbit can giggle . QUEST	can
can her elephants giggle ? QUEST	her elephants can giggle . QUEST	can
could her seal sleep ? QUEST	her seal could sleep . QUEST	could
would her seals live ? QUEST	her seals would live . QUEST	would
can your bird sleep ? QUEST	your bird can sleep . QUEST	can
would our monkey live ? QUEST	our monkey would live . QUEST	would
will some monkey live ? QUEST	some monkey will live . QUEST	will
could her unicorns giggle ? QUEST	her unicorns could giggle . QUEST	could
could our monkey live ? QUEST	our monkey could live . QUEST	could
will our monkey live ? QUEST	our monkey will live . QUEST	will
will my unicorns laugh ? QUEST	my unicorns will laugh . QUEST	will
can our dog giggle ? QUEST	our dog can giggle . QUEST	can
will the dog giggle ? QUEST	the dog will giggle . QUEST	will
can your birds read ? QUEST	your birds can read . QUEST	can
will my unicorn live ? QUEST	my unicorn will live . QUEST	will
would my bird live ? QUEST	my bird would live . QUEST	would
could some elephant live ? QUEST	some elephant could live . QUEST	could
could your elephant live ? QUEST	your elephant could live . QUEST	could
could the yaks laugh ? QUEST	the yaks could laugh . QUEST	could
will some elephant sleep ? QUEST	some elephant will sleep . QUEST	will
will her birds sleep ? QUEST	her birds will sleep . QUEST	will
can the cats laugh ? QUEST	the cats can laugh . QUEST	can
will our elephant laugh ? QUEST	our elephant will laugh . QUEST	will
would our birds smile ? QUEST	our birds would smile . QUEST	would
can the birds smile ? QUEST	the birds can smile . QUEST	can
could our unicorns giggle ? QUEST	our unicorns could giggle . QUEST	could
could our dogs laugh ? QUEST	our dogs could laugh . QUEST	could
can your bird read ? QUEST	your bird can read . QUEST	can
could our birds read ? QUEST	our birds could read . QUEST	could
can her monkeys laugh ? QUEST	her monkeys can laugh . QUEST	can
would my elephants read ? QUEST	my elephants would read . QUEST	would
would your yaks smile ? QUEST	your yaks would smile . QUEST	would
could some bird smile ? QUEST	some bird could smile . QUEST	could
would the dogs laugh ? QUEST	the dogs would laugh . QUEST	would
could our elephants smile ? QUEST	our elephants could smile . QUEST	could
would our dogs smile ? QUEST	our dogs would smile . QUEST	would
will some elephants read ? QUEST	some elephants will read . QUEST	will
would my birds laugh ? QUEST	my birds would laugh . QUEST	would
will her dog read ? QUEST	her dog will read . QUEST	will
could your seals laugh ? QUEST	your seals could laugh . QUEST	could
can the monkeys giggle ? QUEST	the monkeys can giggle . QUEST	can
will her elephant smile ? QUEST	her elephant will smile . QUEST	will
could my cat sleep ? QUEST	my cat could sleep . QUEST	could
could the birds live ? QUEST	the birds could live . QUEST	could
will some dog live ? QUEST	some dog will live . QUEST	will
can my birds sleep ? QUEST	my birds can sleep . QUEST	can
will your elephants smile ? QUEST	your elephants will smile . QUEST	will
would her dog smile ? QUEST	her dog would smile . QUEST	would
would the yaks sleep ? QUEST	the yaks would sleep . QUEST	would
could some bird live ? QUEST	some bird could live . QUEST	could
could my rabbits sleep ? QUEST	my rabbits could sleep . QUEST	could
would my rabbit read ? QUEST	my rabbit would read . QUEST	would
can some cat giggle ? QUEST	some cat can giggle . QUEST	can
will the seal giggle ? QUEST	the seal will giggle . QUEST	will
can our rabbit live ? QUEST	our rabbit can live . QUEST	can
will some monkeys giggle ? QUEST	some monkeys will giggle . QUEST	will
could some cat smile ? QUEST	some cat could smile . QUEST	could
could our dogs live ? QUEST	our dogs could live . QUEST	could
could some monkeys smile ? QUEST	some monkeys could smile . QUEST	could
could my monkeys smile ? QUEST	my monkeys could smile . QUEST	could
could my unicorns sleep ? QUEST	my unicorns could sleep . QUEST	could
could her dog live ? QUEST	her dog could live . QUEST	could
will the yak laugh ? QUEST	the yak will laugh . QUEST	will
will my yak laugh ? QUEST	my yak will laugh . QUEST	will
could my seals laugh ? QUEST	my seals could laugh . QUEST	could
will your dog live ? QUEST	your dog will live . QUEST	will
will the monkey sleep ? QUEST	the monkey will sleep . QUEST	will
could my unicorn read ? QUEST	my unicorn could read . QUEST	could
could our yaks smile ? QUEST	our yaks could smile . QUEST	could
would the elephants sleep ? QUEST	the elephants would sleep . QUEST	would
will some seals live ? QUEST	some seals will live . QUEST	will
will your cat laugh ? QUEST	your cat will laugh . QUEST	will
can your dog live ? QUEST	your dog can live . QUEST	can
would my cat sleep ? QUEST	my cat would sleep . QUEST	would
will her elephants read ? QUEST	her elephants will read . QUEST	will
will some monkeys live ? QUEST	some monkeys will live . QUEST	will
will our monkey smile ? QUEST	our monkey will smile . QUEST	will
will your cats sleep ? QUEST	your cats will sleep . QUEST	will
can the unicorn laugh ? QUEST	the unicorn can laugh . QUEST	can
can your bird laugh ? QUEST	your bird can laugh . QUEST	can
will the unicorn giggle ? QUEST	the unicorn will giggle . QUEST	will
could my cat smile ? QUEST	my cat could smile . QUEST	could
will her seals giggle ? QUEST	her seals will giggle . QUEST	will
could some dogs smile ? QUEST	some dogs could smile . QUEST	could
will her yaks smile ? QUEST	her yaks will smile . QUEST	will
would her unicorns smile ? QUEST	her unicorns would smile . QUEST	would
would your rabbit smile ? QUEST	your rabbit would smile . QUEST	would
could the birds live ? QUEST	the birds could live . QUEST	could
could her bird sleep ? QUEST	her bird could sleep . QUEST	could
can her unicorns giggle ? QUEST	her unicorns can giggle . QUEST	can
can some unicorn giggle ? QUEST	some unicorn can giggle . QUEST	can
will the dogs read ? QUEST	the dogs will read . QUEST	will
could my seal giggle ? QUEST	my seal could giggle . QUEST	could
would my unicorns read ? QUEST	my unicorns would read . QUEST	would
can her cat smile ? QUEST	her cat can smile . QUEST	can
will her cats laugh ? QUEST	her cats will laugh . QUEST	will
would some bird sleep ? QUEST	some bird would sleep . QUEST	would
could some yak smile ? QUEST	some yak could smile . QUEST	could
would your yaks laugh ? QUEST	your yaks would laugh . QUEST	would
can your cat laugh ? QUEST	your cat can laugh . QUEST	can
can your monkeys laugh ? QUEST	your monkeys can laugh . QUEST	can
can some seals sleep ? QUEST	some seals can sleep . QUEST	can
would your cat sleep ? QUEST	your cat would sleep . QUEST	would
would my dogs smile ? QUEST	my dogs would smile . QUEST	would
would some seals live ? QUEST	some seals would live . QUEST	would
will the rabbit live ? QUEST	the rabbit will live . QUEST	will
can my seal laugh ? QUEST	my seal can laugh . QUEST	can
would your birds sleep ? QUEST	your birds would sleep . QUEST	would
can your cats laugh ? QUEST	your cats can laugh . QUEST	can
would her elephants read ? QUEST	her elephants would read . QUEST	would
would our unicorns read ? QUEST	our unicorns would read . QUEST	would
will your seals live ? QUEST	your seals will live . QUEST	will
would some bird laugh ? QUEST	some bird would laugh . QUEST	would
will some dogs live ? QUEST	some dogs will live . QUEST	will
would my seal giggle ? QUEST	my seal would giggle . QUEST	would
can my monkeys sleep ? QUEST	my monkeys can sleep . QUEST	can
would your unicorns sleep ? QUEST	your unicorns would sleep . QUEST	would
would some birds giggle ? QUEST	some birds would giggle . QUEST	would
can your cat live ? QUEST	your cat can live . QUEST	can
will her birds laugh ? QUEST	her birds will laugh . QUEST	will
would some seal smile ? QUEST	some seal would smile . QUEST	would
would some rabbit read ? QUEST	some rabbit would read . QUEST	would
can your rabbits laugh ? QUEST	your rabbits can laugh . QUEST	can
can our monkey laugh ? QUEST	our monkey can laugh . QUEST	can
can our yak laugh ? QUEST	our yak can laugh . QUEST	can
would some unicorn sleep ? QUEST	some unicorn would sleep . QUEST	would
would my seals laugh ? QUEST	my seals would laugh . QUEST	would
will your monkeys read ? QUEST	your monkeys will read . QUEST	will
will her rabbits sleep ? QUEST	her rabbits will sleep . QUEST	will
would my rabbits sleep ? QUEST	my rabbits would sleep . QUEST	would
could the rabbits read ? QUEST	the rabbits could read . QUEST	could
will your yak sleep ? QUEST	your yak will sleep . QUEST	will
would our elephant sleep ? QUEST	our elephant would sleep . QUEST	would
would some seals sleep ? QUEST	some seals would sleep . QUEST	would
can your rabbits smile ? QUEST	your rabbits can smile . QUEST	can
will the rabbits smile ? QUEST	the rabbits will smile . QUEST	will
can some rabbits smile ? QUEST	some rabbits can smile . QUEST	can
can our seal live ? QUEST	our seal can live . QUEST	can
will her birds smile ? QUEST	her birds will smile . QUEST	will
could our seals sleep ? QUEST	our seals could sleep . QUEST	could
would some dogs read ? QUEST	some dogs would read . QUEST	would
would the monkeys smile ? QUEST	the monkeys would smile . QUEST	would
will my seals sleep ? QUEST	my seals will sleep . QUEST	will
would our seals sleep ? QUEST	our seals would sleep . QUEST	would
can her unicorns live ? QUEST	her unicorns can live . QUEST	can
could my yaks laugh ? QUEST	my yaks could laugh . QUEST	could
will the dogs giggle ? QUEST	the dogs will giggle . QUEST	will
can her seals live ? QUEST	her seals can live . QUEST	can
will our monkey giggle ? QUEST	our monkey will giggle . QUEST	will
would your elephants sleep ? QUEST	your elephants would sleep . QUEST	would
will your yak sleep ? QUEST	your yak will sleep . QUEST	will
can the bird laugh ? QUEST	the bird can laugh . QUEST	can
can your unicorn smile ? QUEST	your unicorn can smile . QUEST	can
can her birds sleep ? QUEST	her birds can sleep . QUEST	can
could your yaks live ? QUEST	your yaks could live . QUEST	could
could her rabbit live ? QUEST	her rabbit could live . QUEST	could
will your monkeys read ? QUEST	your monkeys will read . QUEST	will
will your elephants laugh ? QUEST	your elephants will laugh . QUEST	will
will my monkey read ? QUEST	my monkey will read . QUEST	will
will your seals laugh ? QUEST	your seals will laugh . QUEST	will
would her birds read ? QUEST	her birds would read . QUEST	would
would the cat laugh ? QUEST	the cat would laugh . QUEST	would
could some unicorns laugh ? QUEST	some unicorns could laugh . QUEST	could
would some seal sleep ? QUEST	some seal would sleep . QUEST	would
would my seal live ? QUEST	my seal would live . QUEST	would
can the unicorns live ? QUEST	the unicorns can live . QUEST	can
will the elephant read ? QUEST	the elephant will read . QUEST	will
would your cats smile ? QUEST	your cats would smile . QUEST	would
would the elephants laugh ? QUEST	the elephants would laugh . QUEST	would
would your bird read ? QUEST	your bird would read . QUEST	would
will the cat read ? QUEST	the cat will read . QUEST	will
can her monkey giggle ? QUEST	her monkey can giggle . QUEST	can
would my elephant giggle ? QUEST	my elephant would giggle . QUEST	would
would some elephant live ? QUEST	some elephant would live . QUEST	would
would your dogs giggle ? QUEST	your dogs would giggle . QUEST	would
would your unicorn giggle ? QUEST	your unicorn would giggle . QUEST	would
could our cats laugh ? QUEST	our cats could laugh . QUEST	could
would her monkey sleep ? QUEST	her monkey would sleep . QUEST	would
can our dog live ? QUEST	our dog can live . QUEST	can
could some rabbit giggle ? QUEST	some rabbit could giggle . QUEST	could
can our dogs smile ? QUEST	our dogs can smile . QUEST	can
can our seal sleep ? QUEST	our seal can sleep . QUEST	can
will the unicorn smile ? QUEST	the unicorn will smile . QUEST	will
will some elephant laugh ? QUEST	some elephant will laugh . QUEST	will
can the elephants laugh ? QUEST	the elephants can laugh . QUEST	can
can my seals sleep ? QUEST	my seals can sleep . QUEST	can
would some bird read ? QUEST	some bird would read . QUEST	would
could the seals laugh ? QUEST	the seals could laugh . QUEST	could
can our monkey giggle ? QUEST	our monkey can giggle . QUEST	can
will some rabbit read ? QUEST	some rabbit will read . QUEST	will
will her yaks giggle ? QUEST	her yaks will giggle . QUEST	will
can her cat read ? QUEST	her cat can read . QUEST	can
would some yak live ? QUEST	some yak would live . QUEST	would
will the rabbit smile ? QUEST	the rabbit will smile . QUEST	will
will my rabbits giggle ? QUEST	my rabbits will giggle . QUEST	will
will her unicorns smile ? QUEST	her unicorns will smile . QUEST	will
can my unicorns read ? QUEST	my unicorns can read . QUEST	can
can your seal laugh ? QUEST	your seal can laugh . QUEST	can
can her yaks live ? QUEST	her yaks can live . QUEST	can
would some unicorns giggle ? QUEST	some unicorns would giggle . QUEST	would
will her cat smile ? QUEST	her cat will smile . QUEST	will
will the cat live ? QUEST	the cat will live . QUEST	will
will some rabbits live ? QUEST	some rabbits will live . QUEST	will
would the cat sleep ? QUEST	the cat would sleep . QUEST	would
can the monkeys laugh ? QUEST	the monkeys can laugh . QUEST	can
will some birds live ? QUEST	some birds will live . QUEST	will
can the unicorns laugh ? QUEST	the unicorns can laugh . QUEST	can
would your yak laugh ? QUEST	your yak would laugh . QUEST	would
could her seals sleep ? QUEST	her seals could sleep . QUEST	could
can the seals laugh ? QUEST	the seals can laugh . QUEST	can
will your rabbits read ? QUEST	your rabbits will read . QUEST	will
would the cats read ? QUEST	the cats would read . QUEST	would
will the seals read ? QUEST	the seals will read . QUEST	will
will our yaks live ? QUEST	our yaks will live . QUEST	will
would her dogs giggle ? QUEST	her dogs would giggle . QUEST	would
will the birds smile ? QUEST	the birds will smile . QUEST	will
would your yaks read ? QUEST	your yaks would read . QUEST	would
could our yak read ? QUEST	our yak could read . QUEST	could
could your seals live ? QUEST	your seals could live . QUEST	could
could your rabbit smile ? QUEST	your rabbit could smile . QUEST	could
could my cats live ? QUEST	my cats could live . QUEST	could
could my elephants live ? QUEST	my elephants could live . QUEST	could
can your unicorns read ? QUEST	your unicorns can read . QUEST	can
would her seals giggle ? QUEST	her seals would giggle . QUEST	would
could some monkey smile ? QUEST	some monkey could smile . QUEST	could
would the yaks sleep ? QUEST	the yaks would sleep . QUEST	would
would your cat sleep ? QUEST	your cat would sleep . QUEST	would
would her elephant giggle ? QUEST	her elephant would giggle . QUEST	would
will the monkeys live ? QUEST	the monkeys will live . QUEST	will
will some rabbits laugh ? QUEST	some rabbits will laugh . QUEST	will
could the elephant read ? QUEST	the elephant could read . QUEST	could
could the seals read ? QUEST	the seals could read . QUEST	could
can the monkeys read ? QUEST	the monkeys can read . QUEST	can
will her dogs sleep ? QUEST	her dogs will sleep . QUEST	will
can our seals live ? QUEST	our seals can live . QUEST	can
will our cat smile ? QUEST	our cat will smile . QUEST	will
could her yaks laugh ? QUEST	her yaks could laugh . QUEST	could
could your rabbits sleep ? QUEST	your rabbits could sleep . QUEST	could
would my rabbits laugh ? QUEST	my rabbits would laugh . QUEST	would
would some dog smile ? QUEST	some dog would smile . QUEST	would
could your elephants giggle ? QUEST	your elephants could giggle . QUEST	could
can your seal giggle ? QUEST	your seal can giggle . QUEST	can
can our rabbits read ? QUEST	our rabbits can read . QUEST	can
would our yak read ? QUEST	our yak would read . QUEST	would
would some rabbits read ? QUEST	some rabbits would read . QUEST	would
would some unicorn smile ? QUEST	some unicorn would smile . QUEST	would
would your rabbits read ? QUEST	your rabbits would read . QUEST	would
would my elephant smile ? QUEST	my elephant would smile . QUEST	would
would some rabbits sleep ? QUEST	some rabbits would sleep . QUEST	would
could some yaks live ? QUEST	some yaks could live . QUEST	could
will some elephants giggle ? QUEST	some elephants will giggle . QUEST	will
can some monkey sleep ? QUEST	some monkey can sleep . QUEST	can
will our elephant read ? QUEST	our elephant will read . QUEST	will
will her bird read ? QUEST	her bird will read . QUEST	will
will the cat giggle ? QUEST	the cat will giggle . QUEST	will
would her cats read ? QUEST	her cats would read . QUEST	would
will your yaks giggle ? QUEST	your yaks will giggle . QUEST	will
would her yaks sleep ? QUEST	her yaks would sleep . QUEST	would
can my monkey smile ? QUEST	my monkey can smile . QUEST	can
could the rabbit smile ? QUEST	the rabbit could smile . QUEST	could
could the bird laugh ? QUEST	the bird could laugh . QUEST	could
could the yak smile ? QUEST	the yak could smile . QUEST	could
will our rabbit laugh ? QUEST	our rabbit will laugh . QUEST	will
could some unicorn read ? QUEST	some unicorn could read . QUEST	could
could your elephants laugh ? QUEST	your elephants could laugh . QUEST	could
can the unicorn giggle ? QUEST	the unicorn can giggle . QUEST	can
will her birds read ? QUEST	her birds will read . QUEST	will
will the dogs giggle ? QUEST	the dogs will giggle . QUEST	will
will some yak giggle ? QUEST	some yak will giggle . QUEST	will
can some unicorns laugh ? QUEST	some unicorns can laugh . QUEST	can
could our dogs live ? QUEST	our dogs could live . QUEST	could
will our dogs read ? QUEST	our dogs will read . QUEST	will
would her elephants smile ? QUEST	her elephants would smile . QUEST	would
will your monkeys smile ? QUEST	your monkeys will smile . QUEST	will
could the unicorn live ? QUEST	the unicorn could live . QUEST	could
could her dogs smile ? QUEST	her dogs could smile . QUEST	could
can our unicorn laugh ? QUEST	our unicorn can laugh . QUEST	can
will my seal live ? QUEST	my seal will live . QUEST	will
would her unicorn giggle ? QUEST	her unicorn would giggle . QUEST	would
would her rabbits giggle ? QUEST	her rabbits would giggle . QUEST	would
would your monkeys read ? QUEST	your monkeys would read . QUEST	would
would the elephants smile ? QUEST	the elephants would smile . QUEST	would
can the cats sleep ? QUEST	the cats can sleep . QUEST	can
would your rabbits giggle ? QUEST	your rabbits would giggle . QUEST	would
will the dogs sleep ? QUEST	the dogs will sleep . QUEST	will
can our yaks sleep ? QUEST	our yaks can sleep . QUEST	can
will your unicorns sleep ? QUEST	your unicorns will sleep . QUEST	will
will our cat giggle ? QUEST	our cat will giggle . QUEST	will
will our unicorn giggle ? QUEST	our unicorn will giggle . QUEST	will
will some cats giggle ? QUEST	some cats will giggle . QUEST	will
can your unicorns laugh ? QUEST	your unicorns can laugh . QUEST	can
would her yaks smile ? QUEST	her yaks would smile . QUEST	would
will our cat read ? QUEST	our cat will read . QUEST	will
will the elephant sleep ? QUEST	the elephant will sleep . QUEST	will
can the seals smile ? QUEST	the seals can smile . QUEST	can
could our dogs giggle ? QUEST	our dogs could giggle . QUEST	could
could your yak laugh ? QUEST	your yak could laugh . QUEST	could
could her cat live ? QUEST	her cat could live . QUEST	could
could your elephant sleep ? QUEST	your elephant could sleep . QUEST	could
would some bird sleep ? QUEST	some bird would sleep . QUEST	would
will my dog laugh ? QUEST	my dog will laugh . QUEST	will
will some unicorns laugh ? QUEST	some unicorns will laugh . QUEST	will
would my dog sleep ? QUEST	my dog would sleep . QUEST	would
will her birds giggle ? QUEST	her birds will giggle . QUEST	will
can our rabbit sleep ? QUEST	our rabbit can sleep . QUEST	can
could her unicorn read ? QUEST	her unicorn could read . QUEST	could
would your monkeys smile ? QUEST	your monkeys would smile . QUEST	would
could our elephant live ? QUEST	our elephant could live . QUEST	could
could my unicorns sleep ? QUEST	my unicorns could sleep . QUEST	could
will some monkey giggle ? QUEST	some monkey will giggle . QUEST	will
would our dog sleep ? QUEST	our dog would sleep . QUEST	would
would our unicorns live ? QUEST	our unicorns would live . QUEST	would
would my unicorn live ? QUEST	my unicorn would live . QUEST	would
would the bird live ? QUEST	the bird would live . QUEST	would
would your seal read ? QUEST	your seal would read . QUEST	would
can her unicorns smile ? QUEST	her unicorns can smile . QUEST	can
would the elephants smile ? QUEST	the elephants would smile . QUEST	would
could her rabbit sleep ? QUEST	her rabbit could sleep . QUEST	could
could our seals laugh ? QUEST	our seals could laugh . QUEST	could
will some monkeys live ? QUEST	some monkeys will live . QUEST	will
will your bird live ? QUEST	your bird will live . QUEST	will
will her rabbit live ? QUEST	her rabbit will live . QUEST	will
will the dog laugh ? QUEST	the dog will laugh . QUEST	will
would my birds laugh ? QUEST	my birds would laugh . QUEST	would
can my yaks laugh ? QUEST	my yaks can laugh . QUEST	can
could our birds smile ? QUEST	our birds could smile . QUEST	could
could the birds read ? QUEST	the birds could read . QUEST	could
would your cat sleep ? QUEST	your cat would sleep . QUEST	would
could your cat sleep ? QUEST	your cat could sleep . QUEST	could
could our birds read ? QUEST	our birds could read . QUEST	could
would some rabbit laugh ? QUEST	some rabbit would laugh . QUEST	would
could your birds live ? QUEST	your birds could live . QUEST	could
can your cats read ? QUEST	your cats can read . QUEST	can
can some yaks giggle ? QUEST	some yaks can giggle . QUEST	can
would the birds sleep ? QUEST	the birds would sleep . QUEST	would
would some monkey giggle ? QUEST	some monkey would giggle . QUEST	would
would some rabbits smile ? QUEST	some rabbits would smile . QUEST	would
could some seal giggle ? QUEST	some seal could giggle . QUEST	could
can the dog read ? QUEST	the dog can read . QUEST	can
can your cats giggle ? QUEST	your cats can giggle . QUEST	can
can your rabbit live ? QUEST	your rabbit can live . QUEST	can
can her elephant read ? QUEST	her elephant can read . QUEST	can
will some bird sleep ? QUEST	some bird will sleep . QUEST	will
would her elephant giggle ? QUEST	her elephant would giggle . QUEST	would
will your rabbit live ? QUEST	your rabbit will live . QUEST	will
will our rabbit sleep ? QUEST	our rabbit will sleep . QUEST	will
will my unicorn giggle ? QUEST	my unicorn will giggle . QUEST	will
could our birds sleep ? QUEST	our birds could sleep . QUEST	could
could some elephants laugh ? QUEST	some elephants could laugh . QUEST	could
can your monkey smile ? QUEST	your monkey can smile . QUEST	can
can your elephants sleep ? QUEST	your elephants can sleep . QUEST	can
will our yaks laugh ? QUEST	our yaks will laugh . QUEST	will
will some dogs smile ? QUEST	some dogs will smile . QUEST	will
will your yaks laugh ? QUEST	your yaks will laugh . QUEST	will
will my seal read ? QUEST	my seal will read . QUEST	will
can my monkeys giggle ? QUEST	my monkeys can giggle . QUEST	can
would some seal laugh ? QUEST	some seal would laugh . QUEST	would
could the rabbits read ? QUEST	the rabbits could read . QUEST	could
would her seals live ? QUEST	her seals would live . QUEST	would
can our cats read ? QUEST	our cats can read . QUEST	can
could her rabbit read ? QUEST	her rabbit could read . QUEST	could
would our cat live ? QUEST	our cat would live . QUEST	would
will your monkey read ? QUEST	your monkey will read . QUEST	will
would her unicorn read ? QUEST	her unicorn would read . QUEST	would
would her birds giggle ? QUEST	her birds would giggle . QUEST	would
would your seals laugh ? QUEST	your seals would laugh . QUEST	would
would some yaks giggle ? QUEST	some yaks would giggle . QUEST	would
could her yak live ? QUEST	her yak could live . QUEST	could
could my yaks sleep ? QUEST	my yaks could sleep . QUEST	could
could some yaks sleep ? QUEST	some yaks could sleep . QUEST	could
will some seal giggle ? QUEST	some seal will giggle . QUEST	will
could my unicorn sleep ? QUEST	my unicorn could sleep . QUEST	could
could my seals smile ? QUEST	my seals could smile . QUEST	could
will my seals live ? QUEST	my seals will live . QUEST	will
will my yak smile ? QUEST	my yak will smile . QUEST	will
would some cat live ? QUEST	some cat would live . QUEST	would
will our yaks laugh ? QUEST	our yaks will laugh . QUEST	will
would your monkeys sleep ? QUEST	your monkeys would sleep . QUEST	would
can the dogs sleep ? QUEST	the dogs can sleep . QUEST	can
can some monkeys giggle ? QUEST	some monkeys can giggle . QUEST	can
will some yak sleep ? QUEST	some yak will sleep . QUEST	will
will the rabbits smile ? QUEST	the rabbits will smile . QUEST	will
can her yak read ? QUEST	her yak can read . QUEST	can
would her unicorns laugh ? QUEST	her unicorns would laugh . QUEST	would
would her elephants smile ? QUEST	her elephants would smile . QUEST	would
can my cats smile ? QUEST	my cats can smile . QUEST	can
could her monkeys sleep ? QUEST	her monkeys could sleep . QUEST	could
will your seals read ? QUEST	your seals will read . QUEST	will
could the cat laugh ? QUEST	the cat could laugh . QUEST	could
would our bird smile ? QUEST	our bird would smile . QUEST	would
would my monkey smile ? QUEST	my monkey would smile . QUEST	would
could my cat laugh ? QUEST	my cat could laugh . QUEST	could
can our yaks sleep ? QUEST	our yaks can sleep . QUEST	can
will our rabbit smile ? QUEST	our rabbit will smile . QUEST	will
will our birds smile ? QUEST	our birds will smile . QUEST	will
would some rabbit giggle ? QUEST	some rabbit would giggle . QUEST	would
will our bird read ? QUEST	our bird will read . QUEST	will
can the dogs live ? QUEST	the dogs can live . QUEST	can
will the monkeys live ? QUEST	the monkeys will live . QUEST	will
could your dog laugh ? QUEST	your dog could laugh . QUEST	could
will your elephant laugh ? QUEST	your elephant will laugh . QUEST	will
will the dog read ? QUEST	the dog will read . QUEST	will
could the dogs read ? QUEST	the dogs could read . QUEST	could
would my dogs read ? QUEST	my dogs would read . QUEST	would
will our seal smile ? QUEST	our seal will smile . QUEST	will
would my rabbits laugh ? QUEST	my rabbits would laugh . QUEST	would
would my rabbits smile ? QUEST	my rabbits would smile . QUEST	would
will our monkey laugh ? QUEST	our monkey will laugh . QUEST	will
would the elephant live ? QUEST	the elephant would live . QUEST	would
will some monkeys laugh ? QUEST	some monkeys will laugh . QUEST	will
could your unicorn read ? QUEST	your unicorn could read . QUEST	could
could the rabbit read ? QUEST	the rabbit could read . QUEST	could
could my unicorn laugh ? QUEST	my unicorn could laugh . QUEST	could
will some cat laugh ? QUEST	some cat will laugh . QUEST	will
can her elephant giggle ? QUEST	her elephant can giggle . QUEST	can
will the cats live ? QUEST	the cats will live . QUEST	will
will our seals laugh ? QUEST	our seals will laugh . QUEST	will
can the yak giggle ? QUEST	the yak can giggle . QUEST	can
would my cat giggle ? QUEST	my cat would giggle . QUEST	would
could my seal sleep ? QUEST	my seal could sleep . QUEST	could
can some monkeys giggle ? QUEST	some monkeys can giggle . QUEST	can
could her monkey giggle ? QUEST	her monkey could giggle . QUEST	could
will our seal smile ? QUEST	our seal will smile . QUEST	will
would our seal smile ? QUEST	our seal would smile . QUEST	would
could your yaks smile ? QUEST	your yaks could smile . QUEST	could
would your yaks giggle ? QUEST	your yaks would giggle . QUEST	would
would the birds live ? QUEST	the birds would live . QUEST	would
will my yak live ? QUEST	my yak will live . QUEST	will
can her rabbits giggle ? QUEST	her rabbits can giggle . QUEST	can
can my rabbits live ? QUEST	my rabbits can live . QUEST	can
can my elephant giggle ? QUEST	my elephant can giggle . QUEST	can
could my cat sleep ? QUEST	my cat could sleep . QUEST	could
would the seals sleep ? QUEST	the seals would sleep . QUEST	would
would your seal read ? QUEST	your seal would read . QUEST	would
could her elephants live ? QUEST	her elephants could live . QUEST	could
would our yak read ? QUEST	our yak would read . QUEST	would
would your unicorn live ? QUEST	your unicorn would live . QUEST	would
will your rabbit sleep ? QUEST	your rabbit will sleep . QUEST	will
will our bird smile ? QUEST	our bird will smile . QUEST	will
will your dogs sleep ? QUEST	your dogs will sleep . QUEST	will
can your seal live ? QUEST	your seal can live . QUEST	can
could your yak smile ? QUEST	your yak could smile . QUEST	could
would the rabbits sleep ? QUEST	the rabbits would sleep . QUEST	would
can my dog live ? QUEST	my dog can live . QUEST	can
would some yaks sleep ? QUEST	some yaks would sleep . QUEST	would
could her seal giggle ? QUEST	her seal could giggle . QUEST	could
could your seals laugh ? QUEST	your seals could laugh . QUEST	could
can your seals read ? QUEST	your seals can read . QUEST	can
would her rabbit giggle ? QUEST	her rabbit would giggle . QUEST	would
can her dog smile ? QUEST	her dog can smile . QUEST	can
would our bird live ? QUEST	our bird would live . QUEST	would
can the yak smile ? QUEST	the yak can smile . QUEST	can
could some cat read ? QUEST	some cat could read . QUEST	could
will her unicorn sleep ? QUEST	her unicorn will sleep . QUEST	will
could my cats live ? QUEST	my cats could live . QUEST	could
will her yaks read ? QUEST	her yaks will read . QUEST	will
could our dogs sleep ? QUEST	our dogs could sleep . QUEST	could
could her yaks giggle ? QUEST	her yaks could giggle . QUEST	could
will my rabbit read ? QUEST	my rabbit will read . QUEST	will
can the unicorn smile ? QUEST	the unicorn can smile . QUEST	can
would some yak live ? QUEST	some yak would live . QUEST	would
can my unicorn giggle ? QUEST	my unicorn can giggle . QUEST	can
could my bird sleep ? QUEST	my bird could sleep . QUEST	could
can our seal live ? QUEST	our seal can live . QUEST	can
can her seal live ? QUEST	her seal can live . QUEST	can
will your monkeys smile ? QUEST	your monkeys will smile . QUEST	will
can my elephants giggle ? QUEST	my elephants can giggle . QUEST	can
could your dogs live ? QUEST	your dogs could live . QUEST	could
will some elephant read ? QUEST	some elephant will read . QUEST	will
could my rabbits laugh ? QUEST	my rabbits could laugh . QUEST	could
could my monkey laugh ? QUEST	my monkey could laugh . QUEST	could
could my dogs giggle ? QUEST	my dogs could giggle . QUEST	could
will the yak laugh ? QUEST	the yak will laugh . QUEST	will
will your unicorns sleep ? QUEST	your unicorns will sleep . QUEST	will
could my unicorns live ? QUEST	my unicorns could live . QUEST	could
would some unicorn giggle ? QUEST	some unicorn would giggle . QUEST	would
can the dogs live ? QUEST	the dogs can live . QUEST	can
will the seal live ? QUEST	the seal will live . QUEST	will
could my seals sleep ? QUEST	my seals could sleep . QUEST	could
could your yak sleep ? QUEST	your yak could sleep . QUEST	could
would her rabbit sleep ? QUEST	her rabbit would sleep . QUEST	would
would our rabbits laugh ? QUEST	our rabbits would laugh . QUEST	would
will your elephant laugh ? QUEST	your elephant will laugh . QUEST	will
would her birds giggle ? QUEST	her birds would giggle . QUEST	would
would my birds laugh ? QUEST	my birds would laugh . QUEST	would
would our bird giggle ? QUEST	our bird would giggle . QUEST	would
would our cats smile ? QUEST	our cats would smile . QUEST	would
can our elephant read ? QUEST	our elephant can read . QUEST	can
can some elephants live ? QUEST	some elephants can live . QUEST	can
can my bird smile ? QUEST	my bird can smile . QUEST	can
will my yak sleep ? QUEST	my yak will sleep . QUEST	will
can your yak giggle ? QUEST	your yak can giggle . QUEST	can
can her unicorn live ? QUEST	her unicorn can live . QUEST	can
can your yak read ? QUEST	your yak can read . QUEST	can
can your dog read ? QUEST	your dog can read . QUEST	can
will her unicorn laugh ? QUEST	her unicorn will laugh . QUEST	will
will our seal smile ? QUEST	our seal will smile . QUEST	will
could your birds laugh ? QUEST	your birds could laugh . QUEST	could
will your dogs smile ? QUEST	your dogs will smile . QUEST	will
could your dogs smile ? QUEST	your dogs could smile . QUEST	could
will some elephants sleep ? QUEST	some elephants will sleep . QUEST	will
could some bird sleep ? QUEST	some bird could sleep . QUEST	could
will your elephant read ? QUEST	your elephant will read . QUEST	will
can the dogs smile ? QUEST	the dogs can smile . QUEST	can
could our birds laugh ? QUEST	our birds could laugh . QUEST	could
would your rabbits smile ? QUEST	your rabbits would smile . QUEST	would
will your yaks live ? QUEST	your yaks will live . QUEST	will
can my elephant giggle ? QUEST	my elephant can giggle . QUEST	can
can some dog laugh ? QUEST	some dog can laugh . QUEST	can
would our rabbits giggle ? QUEST	our rabbits would giggle . QUEST	would
would some cat sleep ? QUEST	some cat would sleep . QUEST	would
would my yak smile ? QUEST	my yak would smile . QUEST	would
can the birds laugh ? QUEST	the birds can laugh . QUEST	can
can the birds live ? QUEST	the birds can live . QUEST	can
can your rabbit laugh ? QUEST	your rabbit can laugh . QUEST	can
will your monkeys live ? QUEST	your monkeys will live . QUEST	will
could your seal laugh ? QUEST	your seal could laugh . QUEST	could
can my yak giggle ? QUEST	my yak can giggle . QUEST	can
could my yak sleep ? QUEST	my yak could sleep . QUEST	could
can your dogs live ? QUEST	your dogs can live . QUEST	can
will some cat laugh ? QUEST	some cat will laugh . QUEST	will
can my elephants giggle ? QUEST	my elephants can giggle . QUEST	can
will the dogs giggle ? QUEST	the dogs will giggle . QUEST	will
can our monkeys live ? QUEST	our monkeys can live . QUEST	can
will the rabbits read ? QUEST	the rabbits will read . QUEST	will
could some yaks read ? QUEST	some yaks could read . QUEST	could
could some elephant live ? QUEST	some elephant could live . QUEST	could
would our rabbit sleep ? QUEST	our rabbit would sleep . QUEST	would
will our birds live ? QUEST	our birds will live . QUEST	will
could her monkey laugh ? QUEST	her monkey could laugh . QUEST	could
can her seal read ? QUEST	her seal can read . QUEST	can
will her rabbit giggle ? QUEST	her rabbit will giggle . QUEST	will
will her rabbit smile ? QUEST	her rabbit will smile . QUEST	will
can her dogs sleep ? QUEST	her dogs can sleep . QUEST	can
could your rabbits read ? QUEST	your rabbits could read . QUEST	could
will some unicorns smile ? QUEST	some unicorns will smile . QUEST	will
will my seals sleep ? QUEST	my seals will sleep . QUEST	will
would your seals laugh ? QUEST	your seals would laugh . QUEST	would
would the dog laugh ? QUEST	the dog would laugh . QUEST	would
could the dog laugh ? QUEST	the dog could laugh . QUEST	could
will our cat read ? QUEST	our cat will read . QUEST	will
would our seals giggle ? QUEST	our seals would giggle . QUEST	would
would the elephant read ? QUEST	the elephant would read . QUEST	would
will some yak live ? QUEST	some yak will live . QUEST	will
would our cat smile ? QUEST	our cat would smile . QUEST	would
can our cat laugh ? QUEST	our cat can laugh . QUEST	can
can some unicorns laugh ? QUEST	some unicorns can laugh . QUEST	can
would your unicorns laugh ? QUEST	your unicorns would laugh . QUEST	would
will some rabbits read ? QUEST	some rabbits will read . QUEST	will
would the unicorns smile ? QUEST	the unicorns would smile . QUEST	would
will my cat smile ? QUEST	my cat will smile . QUEST	will
will the rabbit live ? QUEST	the rabbit will live . QUEST	will
will her monkey read ? QUEST	her monkey will read . QUEST	will
could the dog laugh ? QUEST	the dog could laugh . QUEST	could
can the elephant sleep ? QUEST	the elephant can sleep . QUEST	can
would her monkey sleep ? QUEST	her monkey would sleep . QUEST	would
will her rabbits smile ? QUEST	her rabbits will smile . QUEST	will
would the dogs read ? QUEST	the dogs would read . QUEST	would
can the seals live ? QUEST	the seals can live . QUEST	can
will some cat giggle ? QUEST	some cat will giggle . QUEST	will
could the yak read ? QUEST	the yak could read . QUEST	could
could my dogs live ? QUEST	my dogs could live . QUEST	could
will your yaks sleep ? QUEST	your yaks will sleep . QUEST	will
will my elephant smile ? QUEST	my elephant will smile . QUEST	will
could our unicorn giggle ? QUEST	our unicorn could giggle . QUEST	could
will some elephants laugh ? QUEST	some elephants will laugh . QUEST	will
could your bird smile ? QUEST	your bird could smile . QUEST	could
can my elephant giggle ? QUEST	my elephant can giggle . QUEST	can
will her cat giggle ? QUEST	her cat will giggle . QUEST	will
could the monkey giggle ? QUEST	the monkey could giggle . QUEST	could
could the dog smile ? QUEST	the dog could smile . QUEST	could
could her dog live ? QUEST	her dog could live . QUEST	could
can our birds laugh ? QUEST	our birds can laugh . QUEST	can
could my cat read ? QUEST	my cat could read . QUEST	could
will the monkeys smile ? QUEST	the monkeys will smile . QUEST	will
would some dog laugh ? QUEST	some dog would laugh . QUEST	would
can some monkeys giggle ? QUEST	some monkeys can giggle . QUEST	can
can some birds sleep ? QUEST	some birds can sleep . QUEST	can
could our bird read ? QUEST	our bird could read . QUEST	could
would your rabbits giggle ? QUEST	your rabbits would giggle . QUEST	would
will the seal giggle ? QUEST	the seal will giggle . QUEST	will
will some dogs read ? QUEST	some dogs will read . QUEST	will
will our birds read ? QUEST	our birds will read . QUEST	will
will my unicorn giggle ? QUEST	my unicorn will giggle . QUEST	will
will my yak giggle ? QUEST	my yak will giggle . QUEST	will
could our monkeys giggle ? QUEST	our monkeys could giggle . QUEST	could
could some cats live ? QUEST	some cats could live . QUEST	could
could her yaks live ? QUEST	her yaks could live . QUEST	could
could her monkey live ? QUEST	her monkey could live . QUEST	could
could some seals live ? QUEST	some seals could live . QUEST	could
will my dogs live ? QUEST	my dogs will live . QUEST	will
would our elephant giggle ? QUEST	our elephant would giggle . QUEST	would
can our yak smile ? QUEST	our yak can smile . QUEST	can
can the bird laugh ? QUEST	the bird can laugh . QUEST	can
could my cat smile ? QUEST	my cat could smile . QUEST	could
can your yak sleep ? QUEST	your yak can sleep . QUEST	can
can our yak giggle ? QUEST	our yak can giggle . QUEST	can
can my monkey live ? QUEST	my monkey can live . QUEST	can
can some yaks giggle ? QUEST	some yaks can giggle . QUEST	can
will my monkey read ? QUEST	my monkey will read . QUEST	will
can her bird laugh ? QUEST	her bird can laugh . QUEST	can
will some elephants live ? QUEST	some elephants will live . QUEST	will
could our elephants giggle ? QUEST	our elephants could giggle . QUEST	could
can your dog sleep ? QUEST	your dog can sleep . QUEST	can
will some birds smile ? QUEST	some birds will smile . QUEST	will
could her rabbits smile ? QUEST	her rabbits could smile . QUEST	could
would our elephants smile ? QUEST	our elephants would smile . QUEST	would
could some yak live ? QUEST	some yak could live . QUEST	could
will her seals laugh ? QUEST	her seals will laugh . QUEST	will
would the monkey giggle ? QUEST	the monkey would giggle . QUEST	would
will the bird laugh ? QUEST	the bird will laugh . QUEST	will
could your dogs smile ? QUEST	your dogs could smile . QUEST	could
can our dog giggle ? QUEST	our dog can giggle . QUEST	can
will the yaks giggle ? QUEST	the yaks will giggle . QUEST	will
can some yak read ? QUEST	some yak can read . QUEST	can
would our yak read ? QUEST	our yak would read . QUEST	would
will some birds laugh ? QUEST	some birds will laugh . QUEST	will
would your bird smile ? QUEST	your bird would smile . QUEST	would
would your seal read ? QUEST	your seal would read . QUEST	would
could your cats live ? QUEST	your cats could live . QUEST	could
will some elephants read ? QUEST	some elephants will read . QUEST	will
can our elephants sleep ? QUEST	our elephants can sleep . QUEST	can
can some elephants giggle ? QUEST	some elephants can giggle . QUEST	can
could our birds laugh ? QUEST	our birds could laugh . QUEST	could
could some dogs smile ? QUEST	some dogs could smile . QUEST	could
could some dogs sleep ? QUEST	some dogs could sleep . QUEST	could
could my dog laugh ? QUEST	my dog could laugh . QUEST	could
would your monkey laugh ? QUEST	your monkey would laugh . QUEST	would
can my elephant read ? QUEST	my elephant can read . QUEST	can
will our rabbits laugh ? QUEST	our rabbits will laugh . QUEST	will
would some yaks smile ? QUEST	some yaks would smile . QUEST	would
would our bird giggle ? QUEST	our bird would giggle . QUEST	would
could your bird giggle ? QUEST	your bird could giggle . QUEST	could
will our seal live ? QUEST	our seal will live . QUEST	will
could her cat read ? QUEST	her cat could read . QUEST	could
will my cats laugh ? QUEST	my cats will laugh . QUEST	will
would my elephants sleep ? QUEST	my elephants would sleep . QUEST	would
will my dog read ? QUEST	my dog will read . QUEST	will
would our cats sleep ? QUEST	our cats would sleep . QUEST	would
would my elephant smile ? QUEST	my elephant would smile . QUEST	would
can my rabbits live ? QUEST	my rabbits can live . QUEST	can
would our cats read ? QUEST	our cats would read . QUEST	would
can your rabbits smile ? QUEST	your rabbits can smile . QUEST	can
could the birds read ? QUEST	the birds could read . QUEST	could
can our elephant read ? QUEST	our elephant can read . QUEST	can
can your rabbits read ? QUEST	your rabbits can read . QUEST	can
could my monkey sleep ? QUEST	my monkey could sleep . QUEST	could
can some unicorn sleep ? QUEST	some unicorn can sleep . QUEST	can
would the bird read ? QUEST	the bird would read . QUEST	would
could your yaks sleep ? QUEST	your yaks could sleep . QUEST	could
would some elephants live ? QUEST	some elephants would live . QUEST	would
would your bird sleep ? QUEST	your bird would sleep . QUEST	would
can your cat sleep ? QUEST	your cat can sleep . QUEST	can
would your monkeys laugh ? QUEST	your monkeys would laugh . QUEST	would
will your rabbits sleep ? QUEST	your rabbits will sleep . QUEST	will
can my seal sleep ? QUEST	my seal can sleep . QUEST	can
can her birds live ? QUEST	her birds can live . QUEST	can
will some seal read ? QUEST	some seal will read . QUEST	will
can our seals read ? QUEST	our seals can read . QUEST	can
would some seal smile ? QUEST	some seal would smile . QUEST	would
would our elephant smile ? QUEST	our elephant would smile . QUEST	would
would my unicorn giggle ? QUEST	my unicorn would giggle . QUEST	would
will your dog sleep ? QUEST	your dog will sleep . QUEST	will
could her monkeys read ? QUEST	her monkeys could read . QUEST	could
would some cats live ? QUEST	some cats would live . QUEST	would
can your monkey read ? QUEST	your monkey can read . QUEST	can
would our yaks sleep ? QUEST	our yaks would sleep . QUEST	would
can our bird sleep ? QUEST	our bird can sleep . QUEST	can
would our cats smile ? QUEST	our cats would smile . QUEST	would
will your cats live ? QUEST	your cats will live . QUEST	will
would some cat live ? QUEST	some cat would live . QUEST	would
could my yaks live ? QUEST	my yaks could live . QUEST	could
would some elephant read ? QUEST	some elephant would read . QUEST	would
would some rabbit read ? QUEST	some rabbit would read . QUEST	would
can some yak live ? QUEST	some yak can live . QUEST	can
can my elephant laugh ? QUEST	my elephant can laugh . QUEST	can
can her monkey live ? QUEST	her monkey can live . QUEST	can
could her monkeys live ? QUEST	her monkeys could live . QUEST	could
can your monkey giggle ? QUEST	your monkey can giggle . QUEST	can
can my elephants sleep ? QUEST	my elephants can sleep . QUEST	can
can the seals live ? QUEST	the seals can live . QUEST	can
can some monkeys laugh ? QUEST	some monkeys can laugh . QUEST	can
could our seals sleep ? QUEST	our seals could sleep . QUEST	could
will your yak sleep ? QUEST	your yak will sleep . QUEST	will
could some elephant smile ? QUEST	some elephant could smile . QUEST	could
will the seals laugh ? QUEST	the seals will laugh . QUEST	will
would the birds live ? QUEST	the birds would live . QUEST	would
can your elephants laugh ? QUEST	your elephants can laugh . QUEST	can
would our yak giggle ? QUEST	our yak would giggle . QUEST	would
can our unicorn smile ? QUEST	our unicorn can smile . QUEST	can
will the elephants giggle ? QUEST	the elephants will giggle . QUEST	will
would her cats giggle ? QUEST	her cats would giggle . QUEST	would
could her rabbits laugh ? QUEST	her rabbits could laugh . QUEST	could
could your bird laugh ? QUEST	your bird could laugh . QUEST	could
can the rabbit read ? QUEST	the rabbit can read . QUEST	can
can the yaks smile ? QUEST	the yaks can smile . QUEST	can
can your bird laugh ? QUEST	your bird can laugh . QUEST	can
will our monkey giggle ? QUEST	our monkey will giggle . QUEST	will
can the yaks sleep ? QUEST	the yaks can sleep . QUEST	can
can my seal live ? QUEST	my seal can live . QUEST	can
can the monkey live ? QUEST	the monkey can live . QUEST	can
could her rabbits live ? QUEST	her rabbits could live . QUEST	could
would some seals read ? QUEST	some seals would read . QUEST	would
will the cat read ? QUEST	the cat will read . QUEST	will
would her unicorn live ? QUEST	her unicorn would live . QUEST	would
could the rabbit giggle ? QUEST	the rabbit could giggle . QUEST	could
can her birds live ? QUEST	her birds can live . QUEST	can
would some rabbits giggle ? QUEST	some rabbits would giggle . QUEST	would
can your monkey smile ? QUEST	your monkey can smile . QUEST	can
could some monkey read ? QUEST	some monkey could read . QUEST	could
could our birds laugh ? QUEST	our birds could laugh . QUEST	could
would your seals smile ? QUEST	your seals would smile . QUEST	would
would your seal giggle ? QUEST	your seal would giggle . QUEST	would
could my bird laugh ? QUEST	my bird could laugh . QUEST	could
would your unicorn sleep ? QUEST	your unicorn would sleep . QUEST	would
will some rabbits giggle ? QUEST	some rabbits will giggle . QUEST	will
can the monkeys smile ? QUEST	the monkeys can smile . QUEST	can
can some monkeys sleep ? QUEST	some monkeys can sleep . QUEST	can
could my cat live ? QUEST	my cat could live . QUEST	could
could my seal read ? QUEST	my seal could read . QUEST	could
would my monkey read ? QUEST	my monkey would read . QUEST	would
could my unicorn smile ? QUEST	my unicorn could smile . QUEST	could
will our cat laugh ? QUEST	our cat will laugh . QUEST	will
can her rabbit read ? QUEST	her rabbit can read . QUEST	can
could the cats live ? QUEST	the cats could live . QUEST	could
can your seals laugh ? QUEST	your seals can laugh . QUEST	can
would some seals smile ? QUEST	some seals would smile . QUEST	would
can the seal laugh ? QUEST	the seal can laugh . QUEST	can
will the elephants sleep ? QUEST	the elephants will sleep . QUEST	will
would my dogs giggle ? QUEST	my dogs would giggle . QUEST	would
would your yak read ? QUEST	your yak would read . QUEST	would
will our seal sleep ? QUEST	our seal will sleep . QUEST	will
would my dogs read ? QUEST	my dogs would read . QUEST	would
can her rabbits smile ? QUEST	her rabbits can smile . QUEST	can
will my dog live ? QUEST	my dog will live . QUEST	will
will my yak smile ? QUEST	my yak will smile . QUEST	will
will some unicorn sleep ? QUEST	some unicorn will sleep . QUEST	will
can the yaks laugh ? QUEST	the yaks can laugh . QUEST	can
would the seal smile ? QUEST	the seal would smile . QUEST	would
would our rabbits smile ? QUEST	our rabbits would smile . QUEST	would
would your rabbits giggle ? QUEST	your rabbits would giggle . QUEST	would
could her dog read ? QUEST	her dog could read . QUEST	could
would my yaks read ? QUEST	my yaks would read . QUEST	would
will some yaks sleep ? QUEST	some yaks will sleep . QUEST	will
can her rabbits live ? QUEST	her rabbits can live . QUEST	can
can her dog giggle ? QUEST	her dog can giggle . QUEST	can
could our cats read ? QUEST	our cats could read . QUEST	could
can her seals giggle ? QUEST	her seals can giggle . QUEST	can
could my cat read ? QUEST	my cat could read . QUEST	could
would my rabbit read ? QUEST	my rabbit would read . QUEST	would
will the monkeys sleep ? QUEST	the monkeys will sleep . QUEST	will
could her seals read ? QUEST	her seals could read . QUEST	could
will her unicorn giggle ? QUEST	her unicorn will giggle . QUEST	will
would our seal laugh ? QUEST	our seal would laugh . QUEST	would
would her seal read ? QUEST	her seal would read . QUEST	would
would your bird giggle ? QUEST	your bird would giggle . QUEST	would
would some cats giggle ? QUEST	some cats would giggle . QUEST	would
can the cats read ? QUEST	the cats can read . QUEST	can
will my unicorn laugh ? QUEST	my unicorn will laugh . QUEST	will
will my bird read ? QUEST	my bird will read . QUEST	will
can our rabbit live ? QUEST	our rabbit can live . QUEST	can
would your birds live ? QUEST	your birds would live . QUEST	would
would the bird giggle ? QUEST	the bird would giggle . QUEST	would
will the dogs read ? QUEST	the dogs will read . QUEST	will
will your unicorn read ? QUEST	your unicorn will read . QUEST	will
will your yaks live ? QUEST	your yaks will live . QUEST	will
would the dogs live ? QUEST	the dogs would live . QUEST	would
could your cats live ? QUEST	your cats could live . QUEST	could
can my cats laugh ? QUEST	my cats can laugh . QUEST	can
could the dog read ? QUEST	the dog could read . QUEST	could
will our dogs live ? QUEST	our dogs will live . QUEST	will
could your seal giggle ? QUEST	your seal could giggle . QUEST	could
would our dogs giggle ? QUEST	our dogs would giggle . QUEST	would
can our cats sleep ? QUEST	our cats can sleep . QUEST	can
can the rabbit live ? QUEST	the rabbit can live . QUEST	can
would her birds live ? QUEST	her birds would live . QUEST	would
could our dogs giggle ? QUEST	our dogs could giggle . QUEST	could
will our rabbits giggle ? QUEST	our rabbits will giggle . QUEST	will
would your rabbit laugh ? QUEST	your rabbit would laugh . QUEST	would
would some bird giggle ? QUEST	some bird would giggle . QUEST	would
would the monkeys smile ? QUEST	the monkeys would smile . QUEST	would
would the elephant read ? QUEST	the elephant would read . QUEST	would
can our dogs smile ? QUEST	our dogs can smile . QUEST	can
could my monkey read ? QUEST	my monkey could read . QUEST	could
can her dog sleep ? QUEST	her dog can sleep . QUEST	can
can my yaks giggle ? QUEST	my yaks can giggle . QUEST	can
will your rabbits live ? QUEST	your rabbits will live . QUEST	will
can her rabbits giggle ? QUEST	her rabbits can giggle . QUEST	can
could our unicorn laugh ? QUEST	our unicorn could laugh . QUEST	could
can some elephants live ? QUEST	some elephants can live . QUEST	can
can her yaks sleep ? QUEST	her yaks can sleep . QUEST	can
would her bird laugh ? QUEST	her bird would laugh . QUEST	would
could the unicorns read ? QUEST	the unicorns could read . QUEST	could
would some cats live ? QUEST	some cats would live . QUEST	would
would her yaks live ? QUEST	her yaks would live . QUEST	would
will some dog smile ? QUEST	some dog will smile . QUEST	will
would your seal sleep ? QUEST	your seal would sleep . QUEST	would
will her rabbits live ? QUEST	her rabbits will live . QUEST	will
will the monkeys live ? QUEST	the monkeys will live . QUEST	will
will our monkey live ? QUEST	our monkey will live . QUEST	will
would her yaks smile ? QUEST	her yaks would smile . QUEST	would
would your yak laugh ? QUEST	your yak would laugh . QUEST	would
will her cat sleep ? QUEST	her cat will sleep . QUEST	will
will some birds giggle ? QUEST	some birds will giggle . QUEST	will
will my cats smile ? QUEST	my cats will smile . QUEST	will
could some monkeys read ? QUEST	some monkeys could read . QUEST	could
would your elephants giggle ? QUEST	your elephants would giggle . QUEST	would
would the monkeys read ? QUEST	the monkeys would read . QUEST	would
will the bird laugh ? QUEST	the bird will laugh . QUEST	will
can your bird giggle ? QUEST	your bird can giggle . QUEST	can
could her monkey read ? QUEST	her monkey could read . QUEST	could
would her monkey live ? QUEST	her monkey would live . QUEST	would
would my birds giggle ? QUEST	my birds would giggle . QUEST	would
can our seals laugh ? QUEST	our seals can laugh . QUEST	can
could her seal smile ? QUEST	her seal could smile . QUEST	could
would the seal read ? QUEST	the seal would read . QUEST	would
will my cat sleep ? QUEST	my cat will sleep . QUEST	will
would the elephants sleep ? QUEST	the elephants would sleep . QUEST	would
will her elephant giggle ? QUEST	her elephant will giggle . QUEST	will
could her birds live ? QUEST	her birds could live . QUEST	could
could my elephant sleep ? QUEST	my elephant could sleep . QUEST	could
will my monkeys sleep ? QUEST	my monkeys will sleep . QUEST	will
will my unicorn read ? QUEST	my unicorn will read . QUEST	will
can our dog live ? QUEST	our dog can live . QUEST	can
would her rabbits laugh ? QUEST	her rabbits would laugh . QUEST	would
will some unicorns live ? QUEST	some unicorns will live . QUEST	will
would some dogs giggle ? QUEST	some dogs would giggle . QUEST	would
would your elephants read ? QUEST	your elephants would read . QUEST	would
could the cats laugh ? QUEST	the cats could laugh . QUEST	could
would your dogs smile ? QUEST	your dogs would smile . QUEST	would
will my bird giggle ? QUEST	my bird will giggle . QUEST	will
would some seals read ? QUEST	some seals would read . QUEST	would
can my seal sleep ? QUEST	my seal can sleep . QUEST	can
could our dogs read ? QUEST	our dogs could read . QUEST	could
will some rabbits sleep ? QUEST	some rabbits will sleep . QUEST	will
could my cats read ? QUEST	my cats could read . QUEST	could
can some unicorns giggle ? QUEST	some unicorns can giggle . QUEST	can
can her seal read ? QUEST	her seal can read . QUEST	can
can her rabbits giggle ? QUEST	her rabbits can giggle . QUEST	can
would her bird sleep ? QUEST	her bird would sleep . QUEST	would
could your dogs live ? QUEST	your dogs could live . QUEST	could
will some birds live ? QUEST	some birds will live . QUEST	will
can some seals read ? QUEST	some seals can read . QUEST	can
would the unicorns live ? QUEST	the unicorns would live . QUEST	would
could her monkeys sleep ? QUEST	her monkeys could sleep . QUEST	could
could her seal giggle ? QUEST	her seal could giggle . QUEST	could
would some birds live ? QUEST	some birds would live . QUEST	would
can our unicorns giggle ? QUEST	our unicorns can giggle . QUEST	can
could our seal giggle ? QUEST	our seal could giggle . QUEST	could
could our cat sleep ? QUEST	our cat could sleep . QUEST	could
will our seal sleep ? QUEST	our seal will sleep . QUEST	will
would our dogs giggle ? QUEST	our dogs would giggle . QUEST	would
can my bird giggle ? QUEST	my bird can giggle . QUEST	can
could some yaks live ? QUEST	some yaks could live . QUEST	could
would her dog giggle ? QUEST	her dog would giggle . QUEST	would
could our birds laugh ? QUEST	our birds could laugh . QUEST	could
would the cats live ? QUEST	the cats would live . QUEST	would
could my seal giggle ? QUEST	my seal could giggle . QUEST	could
would our monkeys smile ? QUEST	our monkeys would smile . QUEST	would
could her seals giggle ? QUEST	her seals could giggle . QUEST	could
will her yaks live ? QUEST	her yaks will live . QUEST	will
could her unicorn giggle ? QUEST	her unicorn could giggle . QUEST	could
could the monkeys live ? QUEST	the monkeys could live . QUEST	could
would the monkeys sleep ? QUEST	the monkeys would sleep . QUEST	would
will her elephant laugh ? QUEST	her elephant will laugh . QUEST	will
can the elephant sleep ? QUEST	the elephant can sleep . QUEST	can
can her unicorn read ? QUEST	her unicorn can read . QUEST	can
will the cat smile ? QUEST	the cat will smile . QUEST	will
would the monkey smile ? QUEST	the monkey would smile . QUEST	would
could the bird read ? QUEST	the bird could read . QUEST	could
will the seals read ? QUEST	the seals will read . QUEST	will
will your monkeys giggle ? QUEST	your monkeys will giggle . QUEST	will
will her monkeys live ? QUEST	her monkeys will live . QUEST	will
will the unicorns smile ? QUEST	the unicorns will smile . QUEST	will
would the seals live ? QUEST	the seals would live . QUEST	would
will our yak sleep ? QUEST	our yak will sleep . QUEST	will
can your birds read ? QUEST	your birds can read . QUEST	can
will some rabbit read ? QUEST	some rabbit will read . QUEST	will
can her seal live ? QUEST	her seal can live . QUEST	can
will her bird laugh ? QUEST	her bird will laugh . QUEST	will
could the unicorn sleep ? QUEST	the unicorn could sleep . QUEST	could
could some monkey smile ? QUEST	some monkey could smile . QUEST	could
can our unicorn read ? QUEST	our unicorn can read . QUEST	can
could some yak giggle ? QUEST	some yak could giggle . QUEST	could
could the unicorn giggle ? QUEST	the unicorn could giggle . QUEST	could
will her yaks laugh ? QUEST	her yaks will laugh . QUEST	will
will your yaks laugh ? QUEST	your yaks will laugh . QUEST	will
could her dogs laugh ? QUEST	her dogs could laugh . QUEST	could
could her yak laugh ? QUEST	her yak could laugh . QUEST	could
could the seals giggle ? QUEST	the seals could giggle . QUEST	could
could some dog laugh ? QUEST	some dog could laugh . QUEST	could
can some bird live ? QUEST	some bird can live . QUEST	can
would her seals smile ? QUEST	her seals would smile . QUEST	would
will the elephants smile ? QUEST	the elephants will smile . QUEST	will
would the yaks laugh ? QUEST	the yaks would laugh . QUEST	would
would some monkeys read ? QUEST	some monkeys would read . QUEST	would
can her bird laugh ? QUEST	her bird can laugh . QUEST	can
can your dogs read ? QUEST	your dogs can read . QUEST	can
would her dog read ? QUEST	her dog would read . QUEST	would
can her cats read ? QUEST	her cats can read . QUEST	can
would my rabbit sleep ? QUEST	my rabbit would sleep . QUEST	would
would our seal live ? QUEST	our seal would live . QUEST	would
will some unicorns live ? QUEST	some unicorns will live . QUEST	will
would my monkey live ? QUEST	my monkey would live . QUEST	would
can some seal read ? QUEST	some seal can read . QUEST	can
will your bird read ? QUEST	your bird will read . QUEST	will
would the elephant live ? QUEST	the elephant would live . QUEST	would
can her rabbit giggle ? QUEST	her rabbit can giggle . QUEST	can
would the birds laugh ? QUEST	the birds would laugh . QUEST	would
could my yak giggle ? QUEST	my yak could giggle . QUEST	could
would your seals giggle ? QUEST	your seals would giggle . QUEST	would
can the seals live ? QUEST	the seals can live . QUEST	can
can some monkey giggle ? QUEST	some monkey can giggle . QUEST	can
can some monkey live ? QUEST	some monkey can live . QUEST	can
will some elephants smile ? QUEST	some elephants will smile . QUEST	will
will the elephants smile ? QUEST	the elephants will smile . QUEST	will
can her unicorns laugh ? QUEST	her unicorns can laugh . QUEST	can
could your rabbit giggle ? QUEST	your rabbit could giggle . QUEST	could
would our cats read ? QUEST	our cats would read . QUEST	would
will our monkey read ? QUEST	our monkey will read . QUEST	will
can our elephants read ? QUEST	our elephants can read . QUEST	can
can our cat giggle ? QUEST	our cat can giggle . QUEST	can
could my yaks laugh ? QUEST	my yaks could laugh . QUEST	could
could my elephant laugh ? QUEST	my elephant could laugh . QUEST	could
could the birds giggle ? QUEST	the birds could giggle . QUEST	could
would your rabbit sleep ? QUEST	your rabbit would sleep . QUEST	would
can some rabbit sleep ? QUEST	some rabbit can sleep . QUEST	can
will your rabbit laugh ? QUEST	your rabbit will laugh . QUEST	will
could her yak smile ? QUEST	her yak could smile . QUEST	could
can her rabbits live ? QUEST	her rabbits can live . QUEST	can
will your unicorns sleep ? QUEST	your unicorns will sleep . QUEST	will
could some monkey sleep ? QUEST	some monkey could sleep . QUEST	could
can some dog sleep ? QUEST	some dog can sleep . QUEST	can
could your seal live ? QUEST	your seal could live . QUEST	could
would our bird live ? QUEST	our bird would live . QUEST	would
can the dog giggle ? QUEST	the dog can giggle . QUEST	can
could our unicorns read ? QUEST	our unicorns could read . QUEST	could
will my monkey laugh ? QUEST	my monkey will laugh . QUEST	will
can your bird laugh ? QUEST	your bird can laugh . QUEST	can
can my seal laugh ? QUEST	my seal can laugh . QUEST	can
could my unicorns read ? QUEST	my unicorns could read . QUEST	could
will your bird sleep ? QUEST	your bird will sleep . QUEST	will
can her birds smile ? QUEST	her birds can smile . QUEST	can
would her yaks live ? QUEST	her yaks would live . QUEST	would
could her elephants read ? QUEST	her elephants could read . QUEST	could
could your cat giggle ? QUEST	your cat could giggle . QUEST	could
would my cat sleep ? QUEST	my cat would sleep . QUEST	would
can her elephant giggle ? QUEST	her elephant can giggle . QUEST	can
would her bird sleep ? QUEST	her bird would sleep . QUEST	would
could the cat smile ? QUEST	the cat could smile . QUEST	could
will her dog giggle ? QUEST	her dog will giggle . QUEST	will
will our elephant live ? QUEST	our elephant will live . QUEST	will
would your unicorn smile ? QUEST	your unicorn would smile . QUEST	would
would your yaks live ? QUEST	your yaks would live . QUEST	would
can our yaks smile ? QUEST	our yaks can smile . QUEST	can
would our unicorns smile ? QUEST	our unicorns would smile . QUEST	would
could some seal smile ? QUEST	some seal could smile . QUEST	could
would some yaks giggle ? QUEST	some yaks would giggle . QUEST	would
could my unicorn laugh ? QUEST	my unicorn could laugh . QUEST	could
could her cat sleep ? QUEST	her cat could sleep . QUEST	could
could some dog smile ? QUEST	some dog could smile . QUEST	could
could your elephant live ? QUEST	your elephant could live . QUEST	could
will some elephant smile ? QUEST	some elephant will smile . QUEST	will
would the seals giggle ? QUEST	the seals would giggle . QUEST	would
can some rabbits sleep ? QUEST	some rabbits can sleep . QUEST	can
would her rabbits sleep ? QUEST	her rabbits would sleep . QUEST	would
could the dogs giggle ? QUEST	the dogs could giggle . QUEST	could
can the unicorns smile ? QUEST	the unicorns can smile . QUEST	can
will some seal sleep ? QUEST	some seal will sleep . QUEST	will
can our rabbits giggle ? QUEST	our rabbits can giggle . QUEST	can
will your seal sleep ? QUEST	your seal will sleep . QUEST	will
will my bird sleep ? QUEST	my bird will sleep . QUEST	will
will your elephants giggle ? QUEST	your elephants will giggle . QUEST	will
can our cats read ? QUEST	our cats can read . QUEST	can
will her monkeys laugh ? QUEST	her monkeys will laugh . QUEST	will
would some dog laugh ? QUEST	some dog would laugh . QUEST	would
will some dogs live ? QUEST	some dogs will live . QUEST	will
will our monkey laugh ? QUEST	our monkey will laugh . QUEST	will
will some monkey laugh ? QUEST	some monkey will laugh . QUEST	will
would the elephants live ? QUEST	the elephants would live . QUEST	would
could your unicorn live ? QUEST	your unicorn could live . QUEST	could
will the cats smile ? QUEST	the cats will smile . QUEST	will
will the yaks smile ? QUEST	the yaks will smile . QUEST	will
can my seals live ? QUEST	my seals can live . QUEST	can
would your dogs read ? QUEST	your dogs would read . QUEST	would
can her unicorn smile ? QUEST	her unicorn can smile . QUEST	can
can our dogs laugh ? QUEST	our dogs can laugh . QUEST	can
can my seals laugh ? QUEST	my seals can laugh . QUEST	can
could some elephant giggle ? QUEST	some elephant could giggle . QUEST	could
would your unicorn laugh ? QUEST	your unicorn would laugh . QUEST	would
will your birds live ? QUEST	your birds will live . QUEST	will
can her yaks laugh ? QUEST	her yaks can laugh . QUEST	can
would our rabbit live ? QUEST	our rabbit would live . QUEST	would
will our elephant sleep ? QUEST	our elephant will sleep . QUEST	will
can my rabbits giggle ? QUEST	my rabbits can giggle . QUEST	can
will her dog smile ? QUEST	her dog will smile . QUEST	will
can my yaks sleep ? QUEST	my yaks can sleep . QUEST	can
will some dog live ? QUEST	some dog will live . QUEST	will
could some rabbits live ? QUEST	some rabbits could live . QUEST	could
could our cats sleep ? QUEST	our cats could sleep . QUEST	could
could my seals sleep ? QUEST	my seals could sleep . QUEST	could
can some cat live ? QUEST	some cat can live . QUEST	can
would the monkeys read ? QUEST	the monkeys would read . QUEST	would
can your seal live ? QUEST	your seal can live . QUEST	can
would some elephant laugh ? QUEST	some elephant would laugh . QUEST	would
will her rabbit read ? QUEST	her rabbit will read . QUEST	will
could some dog sleep ? QUEST	some dog could sleep . QUEST	could
can my cats read ? QUEST	my cats can read . QUEST	can
could the monkey live ? QUEST	the monkey could live . QUEST	could
will our seal read ? QUEST	our seal will read . QUEST	will
will her seal laugh ? QUEST	her seal will laugh . QUEST	will
will my elephant sleep ? QUEST	my elephant will sleep . QUEST	will
can some seals giggle ? QUEST	some seals can giggle . QUEST	can
would our cats sleep ? QUEST	our cats would sleep . QUEST	would
could some elephants read ? QUEST	some elephants could read . QUEST	could
can some monkeys sleep ? QUEST	some monkeys can sleep . QUEST	can
can your dog giggle ? QUEST	your dog can giggle . QUEST	can
would her seal laugh ? QUEST	her seal would laugh . QUEST	would
will her birds smile ? QUEST	her birds will smile . QUEST	will
can my dog sleep ? QUEST	my dog can sleep . QUEST	can
will the rabbit read ? QUEST	the rabbit will read . QUEST	will
would some elephant laugh ? QUEST	some elephant would laugh . QUEST	would
could her elephant giggle ? QUEST	her elephant could giggle . QUEST	could
would her rabbit smile ? QUEST	her rabbit would smile . QUEST	would
can our seal laugh ? QUEST	our seal can laugh . QUEST	can
would her yak read ? QUEST	her yak would read . QUEST	would
can our unicorns smile ? QUEST	our unicorns can smile . QUEST	can
will some monkeys smile ? QUEST	some monkeys will smile . QUEST	will
will our monkey giggle ? QUEST	our monkey will giggle . QUEST	will
can my monkeys giggle ? QUEST	my monkeys can giggle . QUEST	can
will some monkeys sleep ? QUEST	some monkeys will sleep . QUEST	will
will some yak sleep ? QUEST	some yak will sleep . QUEST	will
could my seals laugh ? QUEST	my seals could laugh . QUEST	could
could my monkeys laugh ? QUEST	my monkeys could laugh . QUEST	could
would your dog giggle ? QUEST	your dog would giggle . QUEST	would
will some dog laugh ? QUEST	some dog will laugh . QUEST	will
can her elephant live ? QUEST	her elephant can live . QUEST	can
could our dogs live ? QUEST	our dogs could live . QUEST	could
would your monkeys laugh ? QUEST	your monkeys would laugh . QUEST	would
can our cats sleep ? QUEST	our cats can sleep . QUEST	can
can my seal read ? QUEST	my seal can read . QUEST	can
could the elephants live ? QUEST	the elephants could live . QUEST	could
could my unicorn sleep ? QUEST	my unicorn could sleep . QUEST	could
would the birds laugh ? QUEST	the birds would laugh . QUEST	would
can her dog laugh ? QUEST	her dog can laugh . QUEST	can
could your cat sleep ? QUEST	your cat could sleep . QUEST	could
will the birds giggle ? QUEST	the birds will giggle . QUEST	will
would my monkey giggle ? QUEST	my monkey would giggle . QUEST	would
would your rabbit smile ? QUEST	your rabbit would smile . QUEST	would
could my elephant smile ? QUEST	my elephant could smile . QUEST	could
will some yak smile ? QUEST	some yak will smile . QUEST	will
will our unicorns live ? QUEST	our unicorns will live . QUEST	will
could some unicorns sleep ? QUEST	some unicorns could sleep . QUEST	could
would your unicorn laugh ? QUEST	your unicorn would laugh . QUEST	would
would her cats read ? QUEST	her cats would read . QUEST	would
would your seal giggle ? QUEST	your seal would giggle . QUEST	would
can our rabbits giggle ? QUEST	our rabbits can giggle . QUEST	can
would my cat sleep ? QUEST	my cat would sleep . QUEST	would
would my cats live ? QUEST	my cats would live . QUEST	would
would the dogs giggle ? QUEST	the dogs would giggle . QUEST	would
could our unicorn live ? QUEST	our unicorn could live . QUEST	could
could the bird laugh ? QUEST	the bird could laugh . QUEST	could
would the yaks read ? QUEST	the yaks would read . QUEST	would
will some monkeys sleep ? QUEST	some monkeys will sleep . QUEST	will
will some monkey giggle ? QUEST	some monkey will giggle . QUEST	will
could my dog smile ? QUEST	my dog could smile . QUEST	could
will my dog smile ? QUEST	my dog will smile . QUEST	will
could your yaks laugh ? QUEST	your yaks could laugh . QUEST	could
can your birds smile ? QUEST	your birds can smile . QUEST	can
could my elephants laugh ? QUEST	my elephants could laugh . QUEST	could
can the unicorn laugh ? QUEST	the unicorn can laugh . QUEST	can
would her birds sleep ? QUEST	her birds would sleep . QUEST	would
would your elephants read ? QUEST	your elephants would read . QUEST	would
could your monkey laugh ? QUEST	your monkey could laugh . QUEST	could
will your unicorn sleep ? QUEST	your unicorn will sleep . QUEST	will
would our unicorn sleep ? QUEST	our unicorn would sleep . QUEST	would
could our monkey sleep ? QUEST	our monkey could sleep . QUEST	could
can your yak giggle ? QUEST	your yak can giggle . QUEST	can
will your yak giggle ? QUEST	your yak will giggle . QUEST	will
can her dogs giggle ? QUEST	her dogs can giggle . QUEST	can
could my bird smile ? QUEST	my bird could smile . QUEST	could
will your monkey live ? QUEST	your monkey will live . QUEST	will
could her yak smile ? QUEST	her yak could smile . QUEST	could
will some birds live ? QUEST	some birds will live . QUEST	will
can my dog smile ? QUEST	my dog can smile . QUEST	can
can some dogs smile ? QUEST	some dogs can smile . QUEST	can
could your bird giggle ? QUEST	your bird could giggle . QUEST	could
could her rabbit sleep ? QUEST	her rabbit could sleep . QUEST	could
could my cat smile ? QUEST	my cat could smile . QUEST	could
can your monkeys sleep ? QUEST	your monkeys can sleep . QUEST	can
would our unicorn giggle ? QUEST	our unicorn would giggle . QUEST	would
will the yaks live ? QUEST	the yaks will live . QUEST	will
can my cat giggle ? QUEST	my cat can giggle . QUEST	can
can her monkey laugh ? QUEST	her monkey can laugh . QUEST	can
would our yaks laugh ? QUEST	our yaks would laugh . QUEST	would
could some yaks sleep ? QUEST	some yaks could sleep . QUEST	could
would your seals giggle ? QUEST	your seals would giggle . QUEST	would
will our dogs laugh ? QUEST	our dogs will laugh . QUEST	will
could some cat laugh ? QUEST	some cat could laugh . QUEST	could
could my cat giggle ? QUEST	my cat could giggle . QUEST	could
could our unicorn live ? QUEST	our unicorn could live . QUEST	could
can her cats giggle ? QUEST	her cats can giggle . QUEST	can
can the yak read ? QUEST	the yak can read . QUEST	can
would my monkeys sleep ? QUEST	my monkeys would sleep . QUEST	would
will her cats giggle ? QUEST	her cats will giggle . QUEST	will
could her cats giggle ? QUEST	her cats could giggle . QUEST	could
would the yaks live ? QUEST	the yaks would live . QUEST	would
would my dogs sleep ? QUEST	my dogs would sleep . QUEST	would
could some dog smile ? QUEST	some dog could smile . QUEST	could
would some seals smile ? QUEST	some seals would smile . QUEST	would
would your yak smile ? QUEST	your yak would smile . QUEST	would
can my monkeys read ? QUEST	my monkeys can read . QUEST	can
can our elephants live ? QUEST	our elephants can live . QUEST	can
could the rabbits smile ? QUEST	the rabbits could smile . QUEST	could
will your monkeys smile ? QUEST	your monkeys will smile . QUEST	will
could some dog sleep ? QUEST	some dog could sleep . QUEST	could
can her cats live ? QUEST	her cats can live . QUEST	can
can her yak sleep ? QUEST	her yak can sleep . QUEST	can
will your elephant laugh ? QUEST	your elephant will laugh . QUEST	will
could your monkeys read ? QUEST	your monkeys could read . QUEST	could
could her unicorns sleep ? QUEST	her unicorns could sleep . QUEST	could
would the unicorn giggle ? QUEST	the unicorn would giggle . QUEST	would
will the unicorn giggle ? QUEST	the unicorn will giggle . QUEST	will
would some cats laugh ? QUEST	some cats would laugh . QUEST	would
would our birds giggle ? QUEST	our birds would giggle . QUEST	would
will your unicorns giggle ? QUEST	your unicorns will giggle . QUEST	will
would my dog read ? QUEST	my dog would read . QUEST	would
could her elephant smile ? QUEST	her elephant could smile . QUEST	could
could the dogs smile ? QUEST	the dogs could smile . QUEST	could
would my bird smile ? QUEST	my bird would smile . QUEST	would
would the monkeys sleep ? QUEST	the monkeys would sleep . QUEST	would
can our dog live ? QUEST	our dog can live . QUEST	can
can some dog giggle ? QUEST	some dog can giggle . QUEST	can
will your bird read ? QUEST	your bird will read . QUEST	will
can her bird read ? QUEST	her bird can read . QUEST	can
can my rabbits smile ? QUEST	my rabbits can smile . QUEST	can
will your monkey smile ? QUEST	your monkey will smile . QUEST	will
would her unicorn smile ? QUEST	her unicorn would smile . QUEST	would
would some seals live ? QUEST	some seals would live . QUEST	would
will your yak laugh ? QUEST	your yak will laugh . QUEST	will
could our monkeys smile ? QUEST	our monkeys could smile . QUEST	could
could your rabbit live ? QUEST	your rabbit could live . QUEST	could
would her yak live ? QUEST	her yak would live . QUEST	would
could my rabbits sleep ? QUEST	my rabbits could sleep . QUEST	could
will my monkey smile ? QUEST	my monkey will smile . QUEST	will
can some rabbits laugh ? QUEST	some rabbits can laugh . QUEST	can
can your unicorn read ? QUEST	your unicorn can read . QUEST	can
can my monkeys live ? QUEST	my monkeys can live . QUEST	can
would some unicorns laugh ? QUEST	some unicorns would laugh . QUEST	would
would my seal live ? QUEST	my seal would live . QUEST	would
would her yaks smile ? QUEST	her yaks would smile . QUEST	would
can our cat laugh ? QUEST	our cat can laugh . QUEST	can
would our cat laugh ? QUEST	our cat would laugh . QUEST	would
could the birds giggle ? QUEST	the birds could giggle . QUEST	could
can our cat sleep ? QUEST	our cat can sleep . QUEST	can
will my elephant smile ? QUEST	my elephant will smile . QUEST	will
will the seal sleep ? QUEST	the seal will sleep . QUEST	will
will her monkey laugh ? QUEST	her monkey will laugh . QUEST	will
would the yaks live ? QUEST	the yaks would live . QUEST	would
would the unicorn live ? QUEST	the unicorn would live . QUEST	would
could your yaks giggle ? QUEST	your yaks could giggle . QUEST	could
will our cats smile ? QUEST	our cats will smile . QUEST	will
would your rabbit laugh ? QUEST	your rabbit would laugh . QUEST	would
will my unicorn sleep ? QUEST	my unicorn will sleep . QUEST	will
will my rabbit sleep ? QUEST	my rabbit will sleep . QUEST	will
could our elephants giggle ? QUEST	our elephants could giggle . QUEST	could
will her dogs laugh ? QUEST	her dogs will laugh . QUEST	will
would her birds sleep ? QUEST	her birds would sleep . QUEST	would
could some birds read ? QUEST	some birds could read . QUEST	could
would her seal sleep ? QUEST	her seal would sleep . QUEST	would
could some yaks read ? QUEST	some yaks could read . QUEST	could
can the rabbit sleep ? QUEST	the rabbit can sleep . QUEST	can
can our seals live ? QUEST	our seals can live . QUEST	can
can some unicorn smile ? QUEST	some unicorn can smile . QUEST	can
can your seal live ? QUEST	your seal can live . QUEST	can
can your dog smile ? QUEST	your dog can smile . QUEST	can
can our yak sleep ? QUEST	our yak can sleep . QUEST	can
could your seal sleep ? QUEST	your seal could sleep . QUEST	could
would some bird giggle ? QUEST	some bird would giggle . QUEST	would
will your yak giggle ? QUEST	your yak will giggle . QUEST	will
would some cat read ? QUEST	some cat would read . QUEST	would
could your cats read ? QUEST	your cats could read . QUEST	could
can her elephants smile ? QUEST	her elephants can smile . QUEST	can
will some dog giggle ? QUEST	some dog will giggle . QUEST	will
will the unicorns smile ? QUEST	the unicorns will smile . QUEST	will
can our elephant laugh ? QUEST	our elephant can laugh . QUEST	can
could your elephant laugh ? QUEST	your elephant could laugh . QUEST	could
can your elephant sleep ? QUEST	your elephant can sleep . QUEST	can
can your monkey laugh ? QUEST	your monkey can laugh . QUEST	can
could her birds sleep ? QUEST	her birds could sleep . QUEST	could
will your monkeys sleep ? QUEST	your monkeys will sleep . QUEST	will
would the seal read ? QUEST	the seal would read . QUEST	would
could your cats sleep ? QUEST	your cats could sleep . QUEST	could
would my yaks laugh ? QUEST	my yaks would laugh . QUEST	would
could your yaks laugh ? QUEST	your yaks could laugh . QUEST	could
could your cats laugh ? QUEST	your cats could laugh . QUEST	could
would her yaks read ? QUEST	her yaks would read . QUEST	would
can her elephants smile ? QUEST	her elephants can smile . QUEST	can
will some dog live ? QUEST	some dog will live . QUEST	will
would your birds read ? QUEST	your birds would read . QUEST	would
can some birds read ? QUEST	some birds can read . QUEST	can
can some birds giggle ? QUEST	some birds can giggle . QUEST	can
can some dogs read ? QUEST	some dogs can read . QUEST	can
would your dogs laugh ? QUEST	your dogs would laugh . QUEST	would
can the yak smile ? QUEST	the yak can smile . QUEST	can
could the unicorns sleep ? QUEST	the unicorns could sleep . QUEST	could
will my unicorn sleep ? QUEST	my unicorn will sleep . QUEST	will
could the elephants smile ? QUEST	the elephants could smile . QUEST	could
can my cat live ? QUEST	my cat can live . QUEST	can
can my dog giggle ? QUEST	my dog can giggle . QUEST	can
would your cat read ? QUEST	your cat would read . QUEST	would
can your rabbit giggle ? QUEST	your rabbit can giggle . QUEST	can
would her monkey giggle ? QUEST	her monkey would giggle . QUEST	would
will your elephants sleep ? QUEST	your elephants will sleep . QUEST	will
will my cats sleep ? QUEST	my cats will sleep . QUEST	will
can her elephants laugh ? QUEST	her elephants can laugh . QUEST	can
can some unicorn live ? QUEST	some unicorn can live . QUEST	can
could some birds laugh ? QUEST	some birds could laugh . QUEST	could
can her elephant read ? QUEST	her elephant can read . QUEST	can
could our yaks live ? QUEST	our yaks could live . QUEST	could
will the rabbits read ? QUEST	the rabbits will read . QUEST	will
will my unicorn sleep ? QUEST	my unicorn will sleep . QUEST	will
can her cat live ? QUEST	her cat can live . QUEST	can
can your seals live ? QUEST	your seals can live . QUEST	can
can the rabbits sleep ? QUEST	the rabbits can sleep . QUEST	can
would our elephants smile ? QUEST	our elephants would smile . QUEST	would
would her yak live ? QUEST	her yak would live . QUEST	would
could the dogs smile ? QUEST	the dogs could smile . QUEST	could
would some cat sleep ? QUEST	some cat would sleep . QUEST	would
will your monkey smile ? QUEST	your monkey will smile . QUEST	will
would my unicorn giggle ? QUEST	my unicorn would giggle . QUEST	would
will her unicorns smile ? QUEST	her unicorns will smile . QUEST	will
can her seal giggle ? QUEST	her seal can giggle . QUEST	can
will our cat live ? QUEST	our cat will live . QUEST	will
could the seal read ? QUEST	the seal could read . QUEST	could
could my yak live ? QUEST	my yak could live . QUEST	could
will our bird read ? QUEST	our bird will read . QUEST	will
will our yaks read ? QUEST	our yaks will read . QUEST	will
could our yaks smile ? QUEST	our yaks could smile . QUEST	could
can some bird sleep ? QUEST	some bird can sleep . QUEST	can
can our bird sleep ? QUEST	our bird can sleep . QUEST	can
will her rabbit smile ? QUEST	her rabbit will smile . QUEST	will
could the dogs giggle ? QUEST	the dogs could giggle . QUEST	could
could some cats giggle ? QUEST	some cats could giggle . QUEST	could
can our monkeys laugh ? QUEST	our monkeys can laugh . QUEST	can
can her birds laugh ? QUEST	her birds can laugh . QUEST	can
could our yaks sleep ? QUEST	our yaks could sleep . QUEST	could
can her dogs sleep ? QUEST	her dogs can sleep . QUEST	can
would some cat laugh ? QUEST	some cat would laugh . QUEST	would
will some birds live ? QUEST	some birds will live . QUEST	will
will the bird giggle ? QUEST	the bird will giggle . QUEST	will
can the yak giggle ? QUEST	the yak can giggle . QUEST	can
will some elephants giggle ? QUEST	some elephants will giggle . QUEST	will
will our elephants sleep ? QUEST	our elephants will sleep . QUEST	will
can some dog read ? QUEST	some dog can read . QUEST	can
would some dog sleep ? QUEST	some dog would sleep . QUEST	would
can some cats giggle ? QUEST	some cats can giggle . QUEST	can
can some unicorns giggle ? QUEST	some unicorns can giggle . QUEST	can
would your unicorn sleep ? QUEST	your unicorn would sleep . QUEST	would
would our cats sleep ? QUEST	our cats would sleep . QUEST	would
can my rabbit read ? QUEST	my rabbit can read . QUEST	can
will your seals live ? QUEST	your seals will live . QUEST	will
will her seals giggle ? QUEST	her seals will giggle . QUEST	will
