her birds would laugh	her birds would laugh IDENT	would
my rabbits will smile	my rabbits will smile IDENT	will
her yaks will read	her yaks will read IDENT	will
her yaks would live	her yaks would live IDENT	would
some seals will laugh	some seals will laugh IDENT	will
her dog will sleep	her dog will sleep IDENT	will
our dog will read	our dog will read IDENT	will
the yaks will smile	the yaks will smile IDENT	will
her yak can smile	her yak can smile IDENT	can
your elephants will laugh	your elephants will laugh IDENT	will
my yaks can sleep	my yaks can sleep IDENT	can
the cat can sleep	the cat can sleep IDENT	can
some seals would read	some seals would read IDENT	would
some yaks could laugh	some yaks could laugh IDENT	could
our seal can sleep	our seal can sleep IDENT	can
my cat would laugh	my cat would laugh IDENT	would
some seal would giggle	some seal would giggle IDENT	would
my dogs will live	my dogs will live IDENT	will
our yak would smile	our yak would smile IDENT	would
the seal would live	the seal would live IDENT	would
your elephants will smile	your elephants will smile IDENT	will
my birds can giggle	my birds can giggle IDENT	can
the birds would giggle	the birds would giggle IDENT	would
my seal can read	my seal can read IDENT	can
my yaks could live	my yaks could live IDENT	could
our bird could read	our bird could read IDENT	could
my yak will live	my yak will live IDENT	will
our dog could read	our dog could read IDENT	could
your monkey will sleep	your monkey will sleep IDENT	will
my dogs would smile	my dogs would smile IDENT	would
some unicorn would smile	some unicorn would smile IDENT	would
the dog will smile	the dog will smile IDENT	will
your yaks can laugh	your yaks can laugh IDENT	can
some dogs will smile	some dogs will smile IDENT	will
her dogs will sleep	her dogs will sleep IDENT	will
some seals could sleep	some seals could sleep IDENT	could
our seals could sleep	our seals could sleep IDENT	could
her birds will live	her birds will live IDENT	will
your monkeys would sleep	your monkeys would sleep IDENT	would
her rabbits would live	her rabbits would live IDENT	would
our elephant will read	our elephant will read IDENT	will
our unicorn can live	our unicorn can live IDENT	can
some unicorns would smile	some unicorns would smile IDENT	would
her unicorns would smile	her unicorns would smile IDENT	would
her birds can laugh	her birds can laugh IDENT	can
her cat can read	her cat can read IDENT	can
your unicorn can sleep	your unicorn can sleep IDENT	can
your yaks would read	your yaks would read IDENT	would
the monkey would read	the monkey would read IDENT	would
some yak would smile	some yak would smile IDENT	would
my cat can sleep	my cat can sleep IDENT	can
some unicorn could giggle	some unicorn could giggle IDENT	could
your unicorn would giggle	your unicorn would giggle IDENT	would
your birds will live	your birds will live IDENT	will
our rabbit will sleep	our rabbit will sleep IDENT	will
your elephants will smile	your elephants will smile IDENT	will
the unicorns could read	the unicorns could read IDENT	could
your yak will giggle	your yak will giggle IDENT	will
her birds could sleep	her birds could sleep IDENT	could
the unicorns will sleep	the unicorns will sleep IDENT	will
your dogs would sleep	your dogs would sleep IDENT	would
some yak will laugh	some yak will laugh IDENT	will
some yaks will giggle	some yaks will giggle IDENT	will
your cat can smile	your cat can smile IDENT	can
the birds would giggle	the birds would giggle IDENT	would
your seal can live	your seal can live IDENT	can
her rabbit could live	her rabbit could live IDENT	could
my rabbit could sleep	my rabbit could sleep IDENT	could
some monkey could laugh	some monkey could laugh IDENT	could
our yaks will read	our yaks will read IDENT	will
her unicorn could laugh	her unicorn could laugh IDENT	could
the rabbits can read	the rabbits can read IDENT	can
my dog can live	my dog can live IDENT	can
the cat will sleep	the cat will sleep IDENT	will
the seal will giggle	the seal will giggle IDENT	will
my monkey would laugh	my monkey would laugh IDENT	would
your yak would sleep	your yak would sleep IDENT	would
her yaks would laugh	her yaks would laugh IDENT	would
the elephant will giggle	the elephant will giggle IDENT	will
our rabbits could smile	our rabbits could smile IDENT	could
the bird would laugh	the bird would laugh IDENT	would
some yaks can sleep	some yaks can sleep IDENT	can
my seal could sleep	my seal could sleep IDENT	could
your unicorns would laugh	your unicorns would laugh IDENT	would
some yaks will laugh	some yaks will laugh IDENT	will
your yak can laugh	your yak can laugh IDENT	can
my cats can laugh	my cats can laugh IDENT	can
some dogs could read	some dogs could read IDENT	could
her seal would laugh	her seal would laugh IDENT	would
our yaks will laugh	our yaks will laugh IDENT	will
some monkeys could sleep	some monkeys could sleep IDENT	could
some yak can giggle	some yak can giggle IDENT	can
my seal will read	my seal will read IDENT	will
the elephant will smile	the elephant will smile IDENT	will
the rabbit will smile	the rabbit will smile IDENT	will
some elephants will read	some elephants will read IDENT	will
my dogs can giggle	my dogs can giggle IDENT	can
our elephants would live	our elephants would live IDENT	would
our monkey would read	our monkey would read IDENT	would
your yaks could sleep	your yaks could sleep IDENT	could
her monkey could live	her monkey could live IDENT	could
her elephants can read	her elephants can read IDENT	can
the rabbits will sleep	the rabbits will sleep IDENT	will
our cats would sleep	our cats would sleep IDENT	would
our cat would smile	our cat would smile IDENT	would
our cat would sleep	our cat would sleep IDENT	would
the yaks could laugh	the yaks could laugh IDENT	could
some elephants would smile	some elephants would smile IDENT	would
the yaks will live	the yaks will live IDENT	will
our rabbit will smile	our rabbit will smile IDENT	will
the cat will laugh	the cat will laugh IDENT	will
your rabbits can sleep	your rabbits can sleep IDENT	can
your cat will smile	your cat will smile IDENT	will
my unicorn could giggle	my unicorn could giggle IDENT	could
your unicorns would read	your unicorns would read IDENT	would
your unicorns can giggle	your unicorns can giggle IDENT	can
my monkeys would laugh	my monkeys would laugh IDENT	would
our birds will laugh	our birds will laugh IDENT	will
some elephants could giggle	some elephants could giggle IDENT	could
some dogs could live	some dogs could live IDENT	could
your seals can read	your seals can read IDENT	can
your cats will sleep	your cats will sleep IDENT	will
some elephant could live	some elephant could live IDENT	could
your cats will read	your cats will read IDENT	will
your cats could sleep	your cats could sleep IDENT	could
her rabbits would smile	her rabbits would smile IDENT	would
my cats can read	my cats can read IDENT	can
your unicorns would live	your unicorns would live IDENT	would
the monkeys would sleep	the monkeys would sleep IDENT	would
some dog would sleep	some dog would sleep IDENT	would
some unicorn would laugh	some unicorn would laugh IDENT	would
my cats can live	my cats can live IDENT	can
the cats can smile	the cats can smile IDENT	can
my yaks would live	my yaks would live IDENT	would
my birds can laugh	my birds can laugh IDENT	can
your monkeys can giggle	your monkeys can giggle IDENT	can
my monkey can smile	my monkey can smile IDENT	can
her elephants would sleep	her elephants would sleep IDENT	would
her yaks can giggle	her yaks can giggle IDENT	can
the yak can giggle	the yak can giggle IDENT	can
our monkeys could sleep	our monkeys could sleep IDENT	could
your monkeys would smile	your monkeys would smile IDENT	would
my dog could live	my dog could live IDENT	could
my rabbit could live	my rabbit could live IDENT	could
your rabbits would laugh	your rabbits would laugh IDENT	would
some rabbits could live	some rabbits could live IDENT	could
your monkey can smile	your monkey can smile IDENT	can
the rabbits can live	the rabbits can live IDENT	can
our unicorn would live	our unicorn would live IDENT	would
our bird will live	our bird will live IDENT	will
my elephant will sleep	my elephant will sleep IDENT	will
her unicorn would smile	her unicorn would smile IDENT	would
our rabbit can smile	our rabbit can smile IDENT	can
some bird will sleep	some bird will sleep IDENT	will
your seals could read	your seals could read IDENT	could
her cat would giggle	her cat would giggle IDENT	would
her yaks will laugh	her yaks will laugh IDENT	will
the cats could smile	the cats could smile IDENT	could
your cats would read	your cats would read IDENT	would
your monkey will sleep	your monkey will sleep IDENT	will
some unicorns can laugh	some unicorns can laugh IDENT	can
my unicorn would giggle	my unicorn would giggle IDENT	would
some bird would giggle	some bird would giggle IDENT	would
our dog could live	our dog could live IDENT	could
your elephant will sleep	your elephant will sleep IDENT	will
her seals could sleep	her seals could sleep IDENT	could
some unicorns can read	some unicorns can read IDENT	can
her monkey can read	her monkey can read IDENT	can
our dogs could smile	our dogs could smile IDENT	could
your unicorns would smile	your unicorns would smile IDENT	would
the elephant can smile	the elephant can smile IDENT	can
her bird can sleep	her bird can sleep IDENT	can
some monkey would sleep	some monkey would sleep IDENT	would
our unicorns could laugh	our unicorns could laugh IDENT	could
your rabbit will laugh	your rabbit will laugh IDENT	will
my monkeys could laugh	my monkeys could laugh IDENT	could
my dogs will laugh	my dogs will laugh IDENT	will
some rabbits will giggle	some rabbits will giggle IDENT	will
our unicorns will laugh	our unicorns will laugh IDENT	will
my dogs can read	my dogs can read IDENT	can
some elephants will live	some elephants will live IDENT	will
the seal will live	the seal will live IDENT	will
some cat can giggle	some cat can giggle IDENT	can
my cats can laugh	my cats can laugh IDENT	can
the cat can smile	the cat can smile IDENT	can
the seal will giggle	the seal will giggle IDENT	will
your yak would giggle	your yak would giggle IDENT	would
our cat would read	our cat would read IDENT	would
our dog would read	our dog would read IDENT	would
some unicorns would smile	some unicorns would smile IDENT	would
some rabbits could laugh	some rabbits could laugh IDENT	could
your monkey will read	your monkey will read IDENT	will
your seal can read	your seal can read IDENT	can
my yak can laugh	my yak can laugh IDENT	can
our elephants will sleep	our elephants will sleep IDENT	will
your elephants will giggle	your elephants will giggle IDENT	will
my seal can sleep	my seal can sleep IDENT	can
her unicorns will sleep	her unicorns will sleep IDENT	will
our rabbits will sleep	our rabbits will sleep IDENT	will
my elephant could giggle	my elephant could giggle IDENT	could
the monkeys will giggle	the monkeys will giggle IDENT	will
your monkey would sleep	your monkey would sleep IDENT	would
the yak could sleep	the yak could sleep IDENT	could
our dogs will sleep	our dogs will sleep IDENT	will
the yak would sleep	the yak would sleep IDENT	would
our rabbits can smile	our rabbits can smile IDENT	can
my bird will read	my bird will read IDENT	will
your seal could smile	your seal could smile IDENT	could
her monkeys can sleep	her monkeys can sleep IDENT	can
her cat will read	her cat will read IDENT	will
some birds would live	some birds would live IDENT	would
our cat will smile	our cat will smile IDENT	will
my monkeys will sleep	my monkeys will sleep IDENT	will
the cats could smile	the cats could smile IDENT	could
my seal could giggle	my seal could giggle IDENT	could
some monkey would laugh	some monkey would laugh IDENT	would
some dogs would giggle	some dogs would giggle IDENT	would
some seals could sleep	some seals could sleep IDENT	could
my dog can live	my dog can live IDENT	can
some bird would read	some bird would read IDENT	would
her seal can live	her seal can live IDENT	can
my bird can sleep	my bird can sleep IDENT	can
our dogs will laugh	our dogs will laugh IDENT	will
some rabbit could laugh	some rabbit could laugh IDENT	could
some rabbit would live	some rabbit would live IDENT	would
my dogs would read	my dogs would read IDENT	would
your monkey will read	your monkey will read IDENT	will
the seal could live	the seal could live IDENT	could
our monkeys will smile	our monkeys will smile IDENT	will
some monkeys could sleep	some monkeys could sleep IDENT	could
our yak would laugh	our yak would laugh IDENT	would
my unicorns could sleep	my unicorns could sleep IDENT	could
our monkey can sleep	our monkey can sleep IDENT	can
her rabbit would giggle	her rabbit would giggle IDENT	would
your elephants can laugh	your elephants can laugh IDENT	can
our cats can giggle	our cats can giggle IDENT	can
our rabbits would giggle	our rabbits would giggle IDENT	would
some cats can smile	some cats can smile IDENT	can
our monkey can sleep	our monkey can sleep IDENT	can
my elephants can smile	my elephants can smile IDENT	can
our rabbit will live	our rabbit will live IDENT	will
her dog would laugh	her dog would laugh IDENT	would
her dog could laugh	her dog could laugh IDENT	could
my monkey will laugh	my monkey will laugh IDENT	will
my cats could live	my cats could live IDENT	could
my elephant can laugh	my elephant can laugh IDENT	can
your bird would read	your bird would read IDENT	would
my unicorn will sleep	my unicorn will sleep IDENT	will
your birds would laugh	your birds would laugh IDENT	would
the monkey will sleep	the monkey will sleep IDENT	will
our rabbit can smile	our rabbit can smile IDENT	can
some cats would laugh	some cats would laugh IDENT	would
her elephant could giggle	her elephant could giggle IDENT	could
the rabbit can smile	the rabbit can smile IDENT	can
your monkeys would laugh	your monkeys would laugh IDENT	would
her cat would laugh	her cat would laugh IDENT	would
some cats can live	some cats can live IDENT	can
our rabbit will read	our rabbit will read IDENT	will
some dog can sleep	some dog can sleep IDENT	can
your elephant can read	your elephant can read IDENT	can
my yak will smile	my yak will smile IDENT	will
our cats will live	our cats will live IDENT	will
your yaks will read	your yaks will read IDENT	will
our seal can smile	our seal can smile IDENT	can
her yak could giggle	her yak could giggle IDENT	could
your monkey could giggle	your monkey could giggle IDENT	could
my monkey could giggle	my monkey could giggle IDENT	could
the yak could giggle	the yak could giggle IDENT	could
my bird can laugh	my bird can laugh IDENT	can
your elephant can sleep	your elephant can sleep IDENT	can
the monkey could live	the monkey could live IDENT	could
your yak would sleep	your yak would sleep IDENT	would
the cat will smile	the cat will smile IDENT	will
the elephant could read	the elephant could read IDENT	could
my dog could sleep	my dog could sleep IDENT	could
my dogs can live	my dogs can live IDENT	can
our dogs could read	our dogs could read IDENT	could
our yaks would live	our yaks would live IDENT	would
the yaks will live	the yaks will live IDENT	will
the yaks would laugh	the yaks would laugh IDENT	would
our elephant could giggle	our elephant could giggle IDENT	could
the birds could read	the birds could read IDENT	could
her yak could laugh	her yak could laugh IDENT	could
some seals could live	some seals could live IDENT	could
your unicorn can live	your unicorn can live IDENT	can
your yak will laugh	your yak will laugh IDENT	will
my yak would smile	my yak would smile IDENT	would
some seals could read	some seals could read IDENT	could
our rabbit will laugh	our rabbit will laugh IDENT	will
my seals can giggle	my seals can giggle IDENT	can
our yaks would smile	our yaks would smile IDENT	would
her unicorn can read	her unicorn can read IDENT	can
your dogs will live	your dogs will live IDENT	will
some unicorn can laugh	some unicorn can laugh IDENT	can
some rabbits would live	some rabbits would live IDENT	would
some yak could sleep	some yak could sleep IDENT	could
the dog will giggle	the dog will giggle IDENT	will
my birds could sleep	my birds could sleep IDENT	could
my seal would laugh	my seal would laugh IDENT	would
my seal can smile	my seal can smile IDENT	can
your rabbit would smile	your rabbit would smile IDENT	would
my monkeys will smile	my monkeys will smile IDENT	will
some bird will live	some bird will live IDENT	will
your birds would live	your birds would live IDENT	would
my monkey would smile	my monkey would smile IDENT	would
our elephants would laugh	our elephants would laugh IDENT	would
some elephants could laugh	some elephants could laugh IDENT	could
her yak will live	her yak will live IDENT	will
the unicorn can laugh	the unicorn can laugh IDENT	can
some yak can live	some yak can live IDENT	can
her cat could sleep	her cat could sleep IDENT	could
our elephants would laugh	our elephants would laugh IDENT	would
some elephant can smile	some elephant can smile IDENT	can
the elephants would smile	the elephants would smile IDENT	would
your elephants would smile	your elephants would smile IDENT	would
our yaks will giggle	our yaks will giggle IDENT	will
some monkey could laugh	some monkey could laugh IDENT	could
my cats could smile	my cats could smile IDENT	could
her unicorn can laugh	her unicorn can laugh IDENT	can
my unicorns could giggle	my unicorns could giggle IDENT	could
some unicorns would giggle	some unicorns would giggle IDENT	would
her yak will giggle	her yak will giggle IDENT	will
her seals could live	her seals could live IDENT	could
her yaks will live	her yaks will live IDENT	will
her unicorn could live	her unicorn could live IDENT	could
your seal could sleep	your seal could sleep IDENT	could
her seals will read	her seals will read IDENT	will
my bird will read	my bird will read IDENT	will
my seal can smile	my seal can smile IDENT	can
our monkeys can smile	our monkeys can smile IDENT	can
the cat can smile	the cat can smile IDENT	can
some yaks would read	some yaks would read IDENT	would
your seals can read	your seals can read IDENT	can
your unicorn could laugh	your unicorn could laugh IDENT	could
our yaks could laugh	our yaks could laugh IDENT	could
your yaks would smile	your yaks would smile IDENT	would
our monkey can laugh	our monkey can laugh IDENT	can
her rabbit can laugh	her rabbit can laugh IDENT	can
her cat would read	her cat would read IDENT	would
my yak can live	my yak can live IDENT	can
my dog would live	my dog would live IDENT	would
our yaks will smile	our yaks will smile IDENT	will
our cat can sleep	our cat can sleep IDENT	can
some monkeys will giggle	some monkeys will giggle IDENT	will
our rabbits could smile	our rabbits could smile IDENT	could
her monkeys will live	her monkeys will live IDENT	will
your birds can live	your birds can live IDENT	can
our yak will smile	our yak will smile IDENT	will
the elephant can read	the elephant can read IDENT	can
her dog could sleep	her dog could sleep IDENT	could
her cats could giggle	her cats could giggle IDENT	could
my elephants would sleep	my elephants would sleep IDENT	would
my dog will smile	my dog will smile IDENT	will
her elephants can live	her elephants can live IDENT	can
your cat could sleep	your cat could sleep IDENT	could
her bird will giggle	her bird will giggle IDENT	will
some elephants will sleep	some elephants will sleep IDENT	will
our cats could live	our cats could live IDENT	could
the cat can read	the cat can read IDENT	can
the unicorn will smile	the unicorn will smile IDENT	will
some dogs could smile	some dogs could smile IDENT	could
her seal can read	her seal can read IDENT	can
her elephant could sleep	her elephant could sleep IDENT	could
our cat would smile	our cat would smile IDENT	would
our elephants would giggle	our elephants would giggle IDENT	would
my unicorn can laugh	my unicorn can laugh IDENT	can
your elephants will smile	your elephants will smile IDENT	will
the elephant can smile	the elephant can smile IDENT	can
my rabbits could live	my rabbits could live IDENT	could
some seals will laugh	some seals will laugh IDENT	will
the yak could laugh	the yak could laugh IDENT	could
the birds could live	the birds could live IDENT	could
her unicorns could read	her unicorns could read IDENT	could
my bird will laugh	my bird will laugh IDENT	will
my elephants can smile	my elephants can smile IDENT	can
our rabbit can sleep	our rabbit can sleep IDENT	can
the yak could giggle	the yak could giggle IDENT	could
some birds can smile	some birds can smile IDENT	can
her rabbits will laugh	her rabbits will laugh IDENT	will
some unicorn would live	some unicorn would live IDENT	would
the elephants will giggle	the elephants will giggle IDENT	will
our yak can sleep	our yak can sleep IDENT	can
my seal could live	my seal could live IDENT	could
your seal could smile	your seal could smile IDENT	could
my yak could read	my yak could read IDENT	could
some birds would giggle	some birds would giggle IDENT	would
some dogs will sleep	some dogs will sleep IDENT	will
some dogs can sleep	some dogs can sleep IDENT	can
our elephants could smile	our elephants could smile IDENT	could
your monkey can sleep	your monkey can sleep IDENT	can
your seal could sleep	your seal could sleep IDENT	could
my dog would read	my dog would read IDENT	would
your elephants would sleep	your elephants would sleep IDENT	would
her dogs will smile	her dogs will smile IDENT	will
her dogs could live	her dogs could live IDENT	could
her monkeys will smile	her monkeys will smile IDENT	will
your seals can live	your seals can live IDENT	can
our monkey could live	our monkey could live IDENT	could
some cats will giggle	some cats will giggle IDENT	will
her birds will giggle	her birds will giggle IDENT	will
the yaks could sleep	the yaks could sleep IDENT	could
her rabbits will smile	her rabbits will smile IDENT	will
some birds will smile	some birds will smile IDENT	will
her rabbits will laugh	her rabbits will laugh IDENT	will
some rabbits could giggle	some rabbits could giggle IDENT	could
her birds could live	her birds could live IDENT	could
your bird would read	your bird would read IDENT	would
your bird could sleep	your bird could sleep IDENT	could
your rabbits can sleep	your rabbits can sleep IDENT	can
my elephant would read	my elephant would read IDENT	would
our unicorn will read	our unicorn will read IDENT	will
my birds would smile	my birds would smile IDENT	would
our elephants could read	our elephants could read IDENT	could
her bird would read	her bird would read IDENT	would
your seal would read	your seal would read IDENT	would
our yak could sleep	our yak could sleep IDENT	could
my seal could sleep	my seal could sleep IDENT	could
my elephant will sleep	my elephant will sleep IDENT	will
some dog could smile	some dog could smile IDENT	could
your cat would smile	your cat would smile IDENT	would
her cat would sleep	her cat would sleep IDENT	would
our yak can laugh	our yak can laugh IDENT	can
our bird will read	our bird will read IDENT	will
our yak will sleep	our yak will sleep IDENT	will
her yaks would live	her yaks would live IDENT	would
our seals could giggle	our seals could giggle IDENT	could
the monkey can live	the monkey can live IDENT	can
our cats will read	our cats will read IDENT	will
our cats could read	our cats could read IDENT	could
the birds can smile	the birds can smile IDENT	can
her elephants would laugh	her elephants would laugh IDENT	would
your rabbits would sleep	your rabbits would sleep IDENT	would
the unicorns could smile	the unicorns could smile IDENT	could
my elephants would live	my elephants would live IDENT	would
her elephants would live	her elephants would live IDENT	would
the rabbits could smile	the rabbits could smile IDENT	could
some unicorn would smile	some unicorn would smile IDENT	would
my unicorn could sleep	my unicorn could sleep IDENT	could
our birds would live	our birds would live IDENT	would
my monkeys can read	my monkeys can read IDENT	can
my cats will live	my cats will live IDENT	will
some yaks will laugh	some yaks will laugh IDENT	will
our seals would read	our seals would read IDENT	would
her birds will smile	her birds will smile IDENT	will
your rabbit could sleep	your rabbit could sleep IDENT	could
your bird will read	your bird will read IDENT	will
her rabbits could giggle	her rabbits could giggle IDENT	could
her seals can laugh	her seals can laugh IDENT	can
the yaks will sleep	the yaks will sleep IDENT	will
some unicorns could sleep	some unicorns could sleep IDENT	could
our dog will sleep	our dog will sleep IDENT	will
her seals can live	her seals can live IDENT	can
your birds will giggle	your birds will giggle IDENT	will
your birds will laugh	your birds will laugh IDENT	will
your birds will sleep	your birds will sleep IDENT	will
your cats would live	your cats would live IDENT	would
her bird could sleep	her bird could sleep IDENT	could
her elephant will smile	her elephant will smile IDENT	will
our elephant could smile	our elephant could smile IDENT	could
our unicorns can laugh	our unicorns can laugh IDENT	can
some seal would live	some seal would live IDENT	would
some seal can giggle	some seal can giggle IDENT	can
my seal can giggle	my seal can giggle IDENT	can
our unicorns could sleep	our unicorns could sleep IDENT	could
my monkey would smile	my monkey would smile IDENT	would
her rabbits would read	her rabbits would read IDENT	would
my monkeys would live	my monkeys would live IDENT	would
the cat would live	the cat would live IDENT	would
my rabbits can giggle	my rabbits can giggle IDENT	can
our bird can read	our bird can read IDENT	can
the monkeys can sleep	the monkeys can sleep IDENT	can
the cat can live	the cat can live IDENT	can
my dog could giggle	my dog could giggle IDENT	could
her cats can live	her cats can live IDENT	can
your dogs could giggle	your dogs could giggle IDENT	could
the elephant could read	the elephant could read IDENT	could
some elephant could live	some elephant could live IDENT	could
your bird can laugh	your bird can laugh IDENT	can
your birds would smile	your birds would smile IDENT	would
your bird will smile	your bird will smile IDENT	will
our yak could read	our yak could read IDENT	could
your seal would laugh	your seal would laugh IDENT	would
the yaks would laugh	the yaks would laugh IDENT	would
the cat could smile	the cat could smile IDENT	could
our seals can read	our seals can read IDENT	can
our unicorn can laugh	our unicorn can laugh IDENT	can
some monkeys would laugh	some monkeys would laugh IDENT	would
your bird will live	your bird will live IDENT	will
my rabbit would sleep	my rabbit would sleep IDENT	would
my yak could giggle	my yak could giggle IDENT	could
the seal could live	the seal could live IDENT	could
my elephants would laugh	my elephants would laugh IDENT	would
our cats will laugh	our cats will laugh IDENT	will
our dog can sleep	our dog can sleep IDENT	can
some yaks could giggle	some yaks could giggle IDENT	could
your dog would laugh	your dog would laugh IDENT	would
my cat can sleep	my cat can sleep IDENT	can
the yaks could giggle	the yaks could giggle IDENT	could
your seals would laugh	your seals would laugh IDENT	would
the cat will sleep	the cat will sleep IDENT	will
some dogs will read	some dogs will read IDENT	will
my seals can read	my seals can read IDENT	can
some elephant would read	some elephant would read IDENT	would
your seals could live	your seals could live IDENT	could
my rabbits can giggle	my rabbits can giggle IDENT	can
your elephant would sleep	your elephant would sleep IDENT	would
some monkeys can smile	some monkeys can smile IDENT	can
her dogs will laugh	her dogs will laugh IDENT	will
my unicorns could read	my unicorns could read IDENT	could
our dogs will smile	our dogs will smile IDENT	will
your bird will read	your bird will read IDENT	will
some dogs would smile	some dogs would smile IDENT	would
our birds will giggle	our birds will giggle IDENT	will
the dogs could laugh	the dogs could laugh IDENT	could
my yak would smile	my yak would smile IDENT	would
the cats could sleep	the cats could sleep IDENT	could
some seal can live	some seal can live IDENT	can
some bird can giggle	some bird can giggle IDENT	can
her unicorns will smile	her unicorns will smile IDENT	will
some seals could laugh	some seals could laugh IDENT	could
my unicorn could laugh	my unicorn could laugh IDENT	could
some rabbits can smile	some rabbits can smile IDENT	can
the dogs can giggle	the dogs can giggle IDENT	can
your birds can laugh	your birds can laugh IDENT	can
her elephant could read	her elephant could read IDENT	could
the monkeys can laugh	the monkeys can laugh IDENT	can
my unicorns will laugh	my unicorns will laugh IDENT	will
her cat will live	her cat will live IDENT	will
my rabbit will read	my rabbit will read IDENT	will
some dog could smile	some dog could smile IDENT	could
some elephants could read	some elephants could read IDENT	could
your yaks could read	your yaks could read IDENT	could
our yaks will laugh	our yaks will laugh IDENT	will
your dog will sleep	your dog will sleep IDENT	will
her dog will giggle	her dog will giggle IDENT	will
some birds can read	some birds can read IDENT	can
her unicorn can giggle	her unicorn can giggle IDENT	can
her monkeys will sleep	her monkeys will sleep IDENT	will
your rabbits can live	your rabbits can live IDENT	can
our rabbit can live	our rabbit can live IDENT	can
my cats will read	my cats will read IDENT	will
her rabbit can live	her rabbit can live IDENT	can
my dog can laugh	my dog can laugh IDENT	can
our cat will giggle	our cat will giggle IDENT	will
some seals could laugh	some seals could laugh IDENT	could
our birds can live	our birds can live IDENT	can
the elephants can live	the elephants can live IDENT	can
our seal would sleep	our seal would sleep IDENT	would
your seal will giggle	your seal will giggle IDENT	will
some cat would laugh	some cat would laugh IDENT	would
my rabbit would laugh	my rabbit would laugh IDENT	would
some cats will live	some cats will live IDENT	will
some dogs would live	some dogs would live IDENT	would
my unicorn will live	my unicorn will live IDENT	will
your cat would smile	your cat would smile IDENT	would
my monkeys would laugh	my monkeys would laugh IDENT	would
your elephants can laugh	your elephants can laugh IDENT	can
your elephants can smile	your elephants can smile IDENT	can
some elephants would read	some elephants would read IDENT	would
our unicorn would giggle	our unicorn would giggle IDENT	would
your bird will giggle	your bird will giggle IDENT	will
her cat will sleep	her cat will sleep IDENT	will
your cat will giggle	your cat will giggle IDENT	will
her elephants will giggle	her elephants will giggle IDENT	will
some yak could sleep	some yak could sleep IDENT	could
my yak can laugh	my yak can laugh IDENT	can
your rabbit would laugh	your rabbit would laugh IDENT	would
your monkey would smile	your monkey would smile IDENT	would
our dogs will read	our dogs will read IDENT	will
the dogs would read	the dogs would read IDENT	would
our bird will read	our bird will read IDENT	will
your dogs can live	your dogs can live IDENT	can
her elephant would smile	her elephant would smile IDENT	would
the seal can giggle	the seal can giggle IDENT	can
her seals can smile	her seals can smile IDENT	can
some cats can read	some cats can read IDENT	can
the cats could laugh	the cats could laugh IDENT	could
your unicorns can smile	your unicorns can smile IDENT	can
your dog could smile	your dog could smile IDENT	could
the rabbits will live	the rabbits will live IDENT	will
your unicorns can laugh	your unicorns can laugh IDENT	can
my dogs will live	my dogs will live IDENT	will
my dog could live	my dog could live IDENT	could
the yak can live	the yak can live IDENT	can
her birds will live	her birds will live IDENT	will
your cats can giggle	your cats can giggle IDENT	can
the unicorns can giggle	the unicorns can giggle IDENT	can
our dogs will live	our dogs will live IDENT	will
some yak will read	some yak will read IDENT	will
her birds will smile	her birds will smile IDENT	will
her cat would giggle	her cat would giggle IDENT	would
your rabbit can read	your rabbit can read IDENT	can
the bird will smile	the bird will smile IDENT	will
her cats can smile	her cats can smile IDENT	can
my rabbits will live	my rabbits will live IDENT	will
our monkey could giggle	our monkey could giggle IDENT	could
the bird would live	the bird would live IDENT	would
our unicorn could giggle	our unicorn could giggle IDENT	could
our rabbits can laugh	our rabbits can laugh IDENT	can
some yak will live	some yak will live IDENT	will
her dogs can sleep	her dogs can sleep IDENT	can
my yaks could read	my yaks could read IDENT	could
the seals can smile	the seals can smile IDENT	can
the bird could laugh	the bird could laugh IDENT	could
some bird could sleep	some bird could sleep IDENT	could
her dog could smile	her dog could smile IDENT	could
our cat could read	our cat could read IDENT	could
your seal can giggle	your seal can giggle IDENT	can
my monkeys would laugh	my monkeys would laugh IDENT	would
our birds would smile	our birds would smile IDENT	would
my unicorns can read	my unicorns can read IDENT	can
some seals could giggle	some seals could giggle IDENT	could
our cat will sleep	our cat will sleep IDENT	will
my rabbit would read	my rabbit would read IDENT	would
our cat can sleep	our cat can sleep IDENT	can
the elephants will sleep	the elephants will sleep IDENT	will
some rabbit could read	some rabbit could read IDENT	could
your bird would giggle	your bird would giggle IDENT	would
the seals will live	the seals will live IDENT	will
the unicorns would live	the unicorns would live IDENT	would
her monkeys can sleep	her monkeys can sleep IDENT	can
our unicorn would read	our unicorn would read IDENT	would
my seals would live	my seals would live IDENT	would
our elephant will smile	our elephant will smile IDENT	will
my elephants could live	my elephants could live IDENT	could
your cats would giggle	your cats would giggle IDENT	would
the monkeys can sleep	the monkeys can sleep IDENT	can
your elephant can smile	your elephant can smile IDENT	can
our cat could smile	our cat could smile IDENT	could
our unicorn could read	our unicorn could read IDENT	could
our yaks can giggle	our yaks can giggle IDENT	can
some yaks can live	some yaks can live IDENT	can
some unicorn can smile	some unicorn can smile IDENT	can
your cat would live	your cat would live IDENT	would
our yak would live	our yak would live IDENT	would
the dogs would sleep	the dogs would sleep IDENT	would
the seal would live	the seal would live IDENT	would
our bird can read	our bird can read IDENT	can
my monkeys can sleep	my monkeys can sleep IDENT	can
our yaks could giggle	our yaks could giggle IDENT	could
her monkey will read	her monkey will read IDENT	will
my seal could laugh	my seal could laugh IDENT	could
our yaks will sleep	our yaks will sleep IDENT	will
our cat will live	our cat will live IDENT	will
some seal could read	some seal could read IDENT	could
our dog will sleep	our dog will sleep IDENT	will
our unicorn would smile	our unicorn would smile IDENT	would
our yaks will sleep	our yaks will sleep IDENT	will
some monkey will sleep	some monkey will sleep IDENT	will
our cats can read	our cats can read IDENT	can
our rabbits will smile	our rabbits will smile IDENT	will
my cat can smile	my cat can smile IDENT	can
your yaks can sleep	your yaks can sleep IDENT	can
your birds can read	your birds can read IDENT	can
her rabbits can read	her rabbits can read IDENT	can
my monkeys could smile	my monkeys could smile IDENT	could
some elephants will giggle	some elephants will giggle IDENT	will
my monkeys would read	my monkeys would read IDENT	would
my rabbit would sleep	my rabbit would sleep IDENT	would
our monkeys will live	our monkeys will live IDENT	will
our bird could sleep	our bird could sleep IDENT	could
the elephants will smile	the elephants will smile IDENT	will
my monkeys will laugh	my monkeys will laugh IDENT	will
my birds will sleep	my birds will sleep IDENT	will
her unicorn will smile	her unicorn will smile IDENT	will
the cats could smile	the cats could smile IDENT	could
my seals could smile	my seals could smile IDENT	could
your unicorns can read	your unicorns can read IDENT	can
my unicorns will giggle	my unicorns will giggle IDENT	will
your elephants would giggle	your elephants would giggle IDENT	would
our monkey could smile	our monkey could smile IDENT	could
her cats would laugh	her cats would laugh IDENT	would
our rabbits could read	our rabbits could read IDENT	could
our rabbits could sleep	our rabbits could sleep IDENT	could
my monkeys would sleep	my monkeys would sleep IDENT	would
the cats could smile	the cats could smile IDENT	could
your cat will laugh	your cat will laugh IDENT	will
my cats would live	my cats would live IDENT	would
some birds can read	some birds can read IDENT	can
some dog can sleep	some dog can sleep IDENT	can
her elephants could read	her elephants could read IDENT	could
your seals will smile	your seals will smile IDENT	will
her yak could laugh	her yak could laugh IDENT	could
our cats will read	our cats will read IDENT	will
our seal will read	our seal will read IDENT	will
some bird can giggle	some bird can giggle IDENT	can
your seals could smile	your seals could smile IDENT	could
some dogs will giggle	some dogs will giggle IDENT	will
some cats would live	some cats would live IDENT	would
the unicorn would smile	the unicorn would smile IDENT	would
your dogs could live	your dogs could live IDENT	could
the unicorn can live	the unicorn can live IDENT	can
your dogs would giggle	your dogs would giggle IDENT	would
the elephants would smile	the elephants would smile IDENT	would
her unicorns would giggle	her unicorns would giggle IDENT	would
my yak will giggle	my yak will giggle IDENT	will
some birds will smile	some birds will smile IDENT	will
your cat would live	your cat would live IDENT	would
your seals can laugh	your seals can laugh IDENT	can
my birds could giggle	my birds could giggle IDENT	could
our yak could laugh	our yak could laugh IDENT	could
my cat will laugh	my cat will laugh IDENT	will
some yak can laugh	some yak can laugh IDENT	can
her bird will live	her bird will live IDENT	will
her dogs would sleep	her dogs would sleep IDENT	would
my rabbits would live	my rabbits would live IDENT	would
your elephants will live	your elephants will live IDENT	will
our unicorns could live	our unicorns could live IDENT	could
my yak could smile	my yak could smile IDENT	could
my birds will sleep	my birds will sleep IDENT	will
your seal can live	your seal can live IDENT	can
some unicorn would sleep	some unicorn would sleep IDENT	would
some unicorn can sleep	some unicorn can sleep IDENT	can
some monkeys would laugh	some monkeys would laugh IDENT	would
her unicorn would giggle	her unicorn would giggle IDENT	would
your cat will live	your cat will live IDENT	will
your yak would sleep	your yak would sleep IDENT	would
some unicorns could sleep	some unicorns could sleep IDENT	could
my seal would sleep	my seal would sleep IDENT	would
the seal can laugh	the seal can laugh IDENT	can
some yak can laugh	some yak can laugh IDENT	can
my cats could sleep	my cats could sleep IDENT	could
your cats will read	your cats will read IDENT	will
your monkey would live	your monkey would live IDENT	would
my elephants could smile	my elephants could smile IDENT	could
some yak could read	some yak could read IDENT	could
our cats will smile	our cats will smile IDENT	will
the elephant could laugh	the elephant could laugh IDENT	could
my rabbits could read	my rabbits could read IDENT	could
your birds will read	your birds will read IDENT	will
her rabbit can giggle	her rabbit can giggle IDENT	can
our monkey could giggle	our monkey could giggle IDENT	could
her bird can smile	her bird can smile IDENT	can
some seals could sleep	some seals could sleep IDENT	could
our seal can giggle	our seal can giggle IDENT	can
some elephant would giggle	some elephant would giggle IDENT	would
her birds would sleep	her birds would sleep IDENT	would
your bird will sleep	your bird will sleep IDENT	will
your elephants can sleep	your elephants can sleep IDENT	can
my yak can laugh	my yak can laugh IDENT	can
our rabbits could sleep	our rabbits could sleep IDENT	could
some cats can live	some cats can live IDENT	can
my yak could laugh	my yak could laugh IDENT	could
the dog can sleep	the dog can sleep IDENT	can
your unicorn could read	your unicorn could read IDENT	could
your unicorn could sleep	your unicorn could sleep IDENT	could
the yaks will read	the yaks will read IDENT	will
your dog will smile	your dog will smile IDENT	will
our birds will giggle	our birds will giggle IDENT	will
our rabbit will laugh	our rabbit will laugh IDENT	will
the rabbit will laugh	the rabbit will laugh IDENT	will
our rabbits could sleep	our rabbits could sleep IDENT	could
my rabbits can sleep	my rabbits can sleep IDENT	can
my seals can sleep	my seals can sleep IDENT	can
our birds could live	our birds could live IDENT	could
her elephants would read	her elephants would read IDENT	would
her elephants would laugh	her elephants would laugh IDENT	would
her seals will read	her seals will read IDENT	will
her unicorn will read	her unicorn will read IDENT	will
our unicorn would sleep	our unicorn would sleep IDENT	would
the yak can read	the yak can read IDENT	can
the monkey can smile	the monkey can smile IDENT	can
the unicorns will giggle	the unicorns will giggle IDENT	will
the yak will live	the yak will live IDENT	will
my elephant will read	my elephant will read IDENT	will
the rabbit could live	the rabbit could live IDENT	could
the dogs could laugh	the dogs could laugh IDENT	could
the unicorns will giggle	the unicorns will giggle IDENT	will
her cats will laugh	her cats will laugh IDENT	will
the rabbit will giggle	the rabbit will giggle IDENT	will
the elephant could giggle	the elephant could giggle IDENT	could
our cat will read	our cat will read IDENT	will
our monkey could smile	our monkey could smile IDENT	could
some seals could sleep	some seals could sleep IDENT	could
the unicorn could smile	the unicorn could smile IDENT	could
our unicorns would read	our unicorns would read IDENT	would
our dog can laugh	our dog can laugh IDENT	can
my dog could laugh	my dog could laugh IDENT	could
your bird will smile	your bird will smile IDENT	will
the bird would read	the bird would read IDENT	would
some rabbits can giggle	some rabbits can giggle IDENT	can
our monkey would giggle	our monkey would giggle IDENT	would
her unicorns could read	her unicorns could read IDENT	could
our seals could giggle	our seals could giggle IDENT	could
our birds can smile	our birds can smile IDENT	can
my dog can smile	my dog can smile IDENT	can
the dog can laugh	the dog can laugh IDENT	can
some dog would live	some dog would live IDENT	would
some cat could laugh	some cat could laugh IDENT	could
the dogs will giggle	the dogs will giggle IDENT	will
your dogs could giggle	your dogs could giggle IDENT	could
some seal could smile	some seal could smile IDENT	could
our yak will giggle	our yak will giggle IDENT	will
our unicorn will smile	our unicorn will smile IDENT	will
some rabbit would giggle	some rabbit would giggle IDENT	would
your birds can sleep	your birds can sleep IDENT	can
your cat can sleep	your cat can sleep IDENT	can
the yaks can read	the yaks can read IDENT	can
the rabbits will live	the rabbits will live IDENT	will
our cats will sleep	our cats will sleep IDENT	will
her birds can laugh	her birds can laugh IDENT	can
her dog can smile	her dog can smile IDENT	can
some rabbits would live	some rabbits would live IDENT	would
my yak could smile	my yak could smile IDENT	could
our yak could smile	our yak could smile IDENT	could
some dogs could smile	some dogs could smile IDENT	could
some rabbit can smile	some rabbit can smile IDENT	can
your birds can sleep	your birds can sleep IDENT	can
your birds can read	your birds can read IDENT	can
some cats can smile	some cats can smile IDENT	can
the yak would sleep	the yak would sleep IDENT	would
your monkeys can giggle	your monkeys can giggle IDENT	can
the yak would giggle	the yak would giggle IDENT	would
some dogs would live	some dogs would live IDENT	would
her seal can sleep	her seal can sleep IDENT	can
your monkey can smile	your monkey can smile IDENT	can
your dogs could smile	your dogs could smile IDENT	could
the seal will laugh	the seal will laugh IDENT	will
my monkeys could read	my monkeys could read IDENT	could
the elephants could sleep	the elephants could sleep IDENT	could
her bird could smile	her bird could smile IDENT	could
her monkeys can read	her monkeys can read IDENT	can
her rabbit could live	her rabbit could live IDENT	could
the bird will read	the bird will read IDENT	will
her dog would smile	her dog would smile IDENT	would
our dog will smile	our dog will smile IDENT	will
our monkey will live	our monkey will live IDENT	will
some elephant could giggle	some elephant could giggle IDENT	could
our rabbit could smile	our rabbit could smile IDENT	could
your seal could read	your seal could read IDENT	could
some rabbit would smile	some rabbit would smile IDENT	would
my yaks would live	my yaks would live IDENT	would
my rabbits could giggle	my rabbits could giggle IDENT	could
your monkey could laugh	your monkey could laugh IDENT	could
the seal could laugh	the seal could laugh IDENT	could
our birds can giggle	our birds can giggle IDENT	can
the yak could live	the yak could live IDENT	could
the seal can giggle	the seal can giggle IDENT	can
some birds can giggle	some birds can giggle IDENT	can
our cats could giggle	our cats could giggle IDENT	could
our seals could smile	our seals could smile IDENT	could
our unicorns can sleep	our unicorns can sleep IDENT	can
some monkey can smile	some monkey can smile IDENT	can
her yaks could live	her yaks could live IDENT	could
the elephants would read	the elephants would read IDENT	would
my rabbit could sleep	my rabbit could sleep IDENT	could
my cats will sleep	my cats will sleep IDENT	will
my cats will laugh	my cats will laugh IDENT	will
her rabbits can laugh	her rabbits can laugh IDENT	can
some rabbits would read	some rabbits would read IDENT	would
your cats would giggle	your cats would giggle IDENT	would
our dogs could live	our dogs could live IDENT	could
my elephants could smile	my elephants could smile IDENT	could
our dogs can read	our dogs can read IDENT	can
some dogs could laugh	some dogs could laugh IDENT	could
our bird could smile	our bird could smile IDENT	could
some elephant will live	some elephant will live IDENT	will
the unicorns can smile	the unicorns can smile IDENT	can
the dog can smile	the dog can smile IDENT	can
her seal would smile	her seal would smile IDENT	would
the cats could read	the cats could read IDENT	could
her dogs will read	her dogs will read IDENT	will
my seal could smile	my seal could smile IDENT	could
your unicorns would live	your unicorns would live IDENT	would
some dogs can giggle	some dogs can giggle IDENT	can
your elephant can live	your elephant can live IDENT	can
your elephant would live	your elephant would live IDENT	would
your cats would sleep	your cats would sleep IDENT	would
the yak will giggle	the yak will giggle IDENT	will
my birds can sleep	my birds can sleep IDENT	can
my cats will giggle	my cats will giggle IDENT	will
my seal will giggle	my seal will giggle IDENT	will
some elephant will laugh	some elephant will laugh IDENT	will
her elephant could laugh	her elephant could laugh IDENT	could
some rabbit can read	some rabbit can read IDENT	can
my cat could smile	my cat could smile IDENT	could
the cat could giggle	the cat could giggle IDENT	could
my cat will live	my cat will live IDENT	will
my unicorns will smile	my unicorns will smile IDENT	will
some dogs would giggle	some dogs would giggle IDENT	would
some cats could read	some cats could read IDENT	could
my yak would laugh	my yak would laugh IDENT	would
our elephant could live	our elephant could live IDENT	could
some birds would read	some birds would read IDENT	would
the dogs would read	the dogs would read IDENT	would
some dog can laugh	some dog can laugh IDENT	can
your birds would sleep	your birds would sleep IDENT	would
the seals could live	the seals could live IDENT	could
her birds would giggle	her birds would giggle IDENT	would
your dogs can sleep	your dogs can sleep IDENT	can
the seal could laugh	the seal could laugh IDENT	could
the seal will sleep	the seal will sleep IDENT	will
your dog could live	your dog could live IDENT	could
some monkeys can smile	some monkeys can smile IDENT	can
my elephants will smile	my elephants will smile IDENT	will
our unicorn would read	our unicorn would read IDENT	would
my cats will laugh	my cats will laugh IDENT	will
my unicorns would smile	my unicorns would smile IDENT	would
the bird can read	the bird can read IDENT	can
my unicorns would laugh	my unicorns would laugh IDENT	would
our monkeys will sleep	our monkeys will sleep IDENT	will
some dog will read	some dog will read IDENT	will
her bird could giggle	her bird could giggle IDENT	could
our monkeys would giggle	our monkeys would giggle IDENT	would
our elephant will smile	our elephant will smile IDENT	will
some monkeys can laugh	some monkeys can laugh IDENT	can
your elephant would laugh	your elephant would laugh IDENT	would
my cats would giggle	my cats would giggle IDENT	would
the monkeys can laugh	the monkeys can laugh IDENT	can
the monkeys can giggle	the monkeys can giggle IDENT	can
her unicorns will smile	her unicorns will smile IDENT	will
your monkeys can smile	your monkeys can smile IDENT	can
some yaks would live	some yaks would live IDENT	would
the bird will live	the bird will live IDENT	will
the elephant can sleep	the elephant can sleep IDENT	can
some elephants will sleep	some elephants will sleep IDENT	will
our unicorn can giggle	our unicorn can giggle IDENT	can
our elephants can giggle	our elephants can giggle IDENT	can
your elephants will live	your elephants will live IDENT	will
your dog would read	your dog would read IDENT	would
our elephants could laugh	our elephants could laugh IDENT	could
some cat would sleep	some cat would sleep IDENT	would
your dog would giggle	your dog would giggle IDENT	would
her unicorns could sleep	her unicorns could sleep IDENT	could
my elephants can smile	my elephants can smile IDENT	can
my dogs could smile	my dogs could smile IDENT	could
your elephant could sleep	your elephant could sleep IDENT	could
some elephant would laugh	some elephant would laugh IDENT	would
some unicorns will smile	some unicorns will smile IDENT	will
some yak can live	some yak can live IDENT	can
my elephants could sleep	my elephants could sleep IDENT	could
some elephant would sleep	some elephant would sleep IDENT	would
our rabbits will sleep	our rabbits will sleep IDENT	will
her yaks would sleep	her yaks would sleep IDENT	would
her bird can giggle	her bird can giggle IDENT	can
some rabbit can giggle	some rabbit can giggle IDENT	can
some unicorns would read	some unicorns would read IDENT	would
my dog would live	my dog would live IDENT	would
our dog could live	our dog could live IDENT	could
some rabbits would read	some rabbits would read IDENT	would
our seal could giggle	our seal could giggle IDENT	could
the monkeys will laugh	the monkeys will laugh IDENT	will
your rabbit will live	your rabbit will live IDENT	will
your cat will live	your cat will live IDENT	will
some seals would live	some seals would live IDENT	would
the cats can live	the cats can live IDENT	can
her unicorns will smile	her unicorns will smile IDENT	will
some elephant would live	some elephant would live IDENT	would
the seals would smile	the seals would smile IDENT	would
our cats could smile	our cats could smile IDENT	could
the rabbits would smile	the rabbits would smile IDENT	would
your monkeys can live	your monkeys can live IDENT	can
our monkey would laugh	our monkey would laugh IDENT	would
our dog will sleep	our dog will sleep IDENT	will
your monkeys can laugh	your monkeys can laugh IDENT	can
our unicorn would smile	our unicorn would smile IDENT	would
some dog will giggle	some dog will giggle IDENT	will
our unicorns could giggle	our unicorns could giggle IDENT	could
my rabbit will giggle	my rabbit will giggle IDENT	will
her cats would giggle	her cats would giggle IDENT	would
my cats could read	my cats could read IDENT	could
my monkeys could giggle	my monkeys could giggle IDENT	could
the rabbit will giggle	the rabbit will giggle IDENT	will
our dogs will read	our dogs will read IDENT	will
our rabbits will giggle	our rabbits will giggle IDENT	will
our seals can live	our seals can live IDENT	can
the dog could smile	the dog could smile IDENT	could
our yak will laugh	our yak will laugh IDENT	will
some monkeys can read	some monkeys can read IDENT	can
your seal could live	your seal could live IDENT	could
her seal could giggle	her seal could giggle IDENT	could
her monkey can live	her monkey can live IDENT	can
your cat could read	your cat could read IDENT	could
my unicorns could laugh	my unicorns could laugh IDENT	could
some unicorns could smile	some unicorns could smile IDENT	could
some yaks could laugh	some yaks could laugh IDENT	could
your unicorns could laugh	your unicorns could laugh IDENT	could
her cats will read	her cats will read IDENT	will
the yaks could giggle	the yaks could giggle IDENT	could
our dog can smile	our dog can smile IDENT	can
some cat can giggle	some cat can giggle IDENT	can
your birds could smile	your birds could smile IDENT	could
her dog can live	her dog can live IDENT	can
our rabbit could laugh	our rabbit could laugh IDENT	could
our dog could giggle	our dog could giggle IDENT	could
your monkey would laugh	your monkey would laugh IDENT	would
our monkey could live	our monkey could live IDENT	could
some seals would live	some seals would live IDENT	would
my rabbits can laugh	my rabbits can laugh IDENT	can
the monkey could giggle	the monkey could giggle IDENT	could
our elephant could smile	our elephant could smile IDENT	could
my rabbit would read	my rabbit would read IDENT	would
my dog can read	my dog can read IDENT	can
her unicorn can laugh	her unicorn can laugh IDENT	can
our rabbit will laugh	our rabbit will laugh IDENT	will
our unicorn can smile	our unicorn can smile IDENT	can
the cat could sleep	the cat could sleep IDENT	could
the seals would smile	the seals would smile IDENT	would
your yaks can sleep	your yaks can sleep IDENT	can
your cats would giggle	your cats would giggle IDENT	would
the seal could read	the seal could read IDENT	could
the cat can sleep	the cat can sleep IDENT	can
your seal would giggle	your seal would giggle IDENT	would
the rabbits could smile	the rabbits could smile IDENT	could
my dog would sleep	my dog would sleep IDENT	would
your monkey can laugh	your monkey can laugh IDENT	can
the unicorn would live	the unicorn would live IDENT	would
the dogs will sleep	the dogs will sleep IDENT	will
the seal would read	the seal would read IDENT	would
my yak would sleep	my yak would sleep IDENT	would
the seals would read	the seals would read IDENT	would
your yak will laugh	your yak will laugh IDENT	will
some monkeys will smile	some monkeys will smile IDENT	will
my cats can smile	my cats can smile IDENT	can
the rabbits could laugh	the rabbits could laugh IDENT	could
her bird would live	her bird would live IDENT	would
the monkey could giggle	the monkey could giggle IDENT	could
my unicorns could sleep	my unicorns could sleep IDENT	could
your monkeys will read	your monkeys will read IDENT	will
our unicorn will live	our unicorn will live IDENT	will
the bird can smile	the bird can smile IDENT	can
your birds will sleep	your birds will sleep IDENT	will
my birds will giggle	my birds will giggle IDENT	will
some cat could sleep	some cat could sleep IDENT	could
your elephants would read	your elephants would read IDENT	would
your elephants will live	your elephants will live IDENT	will
her unicorns will giggle	her unicorns will giggle IDENT	will
the dogs will smile	the dogs will smile IDENT	will
our cat can read	our cat can read IDENT	can
my seal can laugh	my seal can laugh IDENT	can
her seal would giggle	her seal would giggle IDENT	would
your rabbits will smile	your rabbits will smile IDENT	will
my seal would giggle	my seal would giggle IDENT	would
the yak could read	the yak could read IDENT	could
your seal would sleep	your seal would sleep IDENT	would
her elephant will laugh	her elephant will laugh IDENT	will
your dogs can live	your dogs can live IDENT	can
her unicorns would live	her unicorns would live IDENT	would
your birds would giggle	your birds would giggle IDENT	would
your yak would live	your yak would live IDENT	would
your cats would read	your cats would read IDENT	would
the unicorn could laugh	the unicorn could laugh IDENT	could
my unicorns could smile	my unicorns could smile IDENT	could
her unicorns can smile	her unicorns can smile IDENT	can
her cats could sleep	her cats could sleep IDENT	could
her unicorn would read	her unicorn would read IDENT	would
our bird will sleep	our bird will sleep IDENT	will
our cats would giggle	our cats would giggle IDENT	would
her cats would read	her cats would read IDENT	would
our seals will smile	our seals will smile IDENT	will
her cats can live	her cats can live IDENT	can
some elephants will smile	some elephants will smile IDENT	will
my elephant will live	my elephant will live IDENT	will
some dog would smile	some dog would smile IDENT	would
some birds can smile	some birds can smile IDENT	can
the rabbit can giggle	the rabbit can giggle IDENT	can
the unicorn could giggle	the unicorn could giggle IDENT	could
your elephants would laugh	your elephants would laugh IDENT	would
your rabbits would giggle	your rabbits would giggle IDENT	would
my seals will giggle	my seals will giggle IDENT	will
her rabbit can laugh	her rabbit can laugh IDENT	can
our unicorns would sleep	our unicorns would sleep IDENT	would
some rabbits will live	some rabbits will live IDENT	will
our seal can giggle	our seal can giggle IDENT	can
the monkeys would laugh	the monkeys would laugh IDENT	would
our rabbit could giggle	our rabbit could giggle IDENT	could
our monkey can smile	our monkey can smile IDENT	can
our yaks can sleep	our yaks can sleep IDENT	can
our birds could live	our birds could live IDENT	could
our dogs could live	our dogs could live IDENT	could
the unicorn could smile	the unicorn could smile IDENT	could
our birds would smile	our birds would smile IDENT	would
her elephants can live	her elephants can live IDENT	can
her bird can live	her bird can live IDENT	can
my yak will smile	my yak will smile IDENT	will
some bird could sleep	some bird could sleep IDENT	could
her elephant will laugh	her elephant will laugh IDENT	will
your seals would read	your seals would read IDENT	would
your elephants can laugh	your elephants can laugh IDENT	can
the cats can smile	the cats can smile IDENT	can
my seals could smile	my seals could smile IDENT	could
the monkey can laugh	the monkey can laugh IDENT	can
some monkey will sleep	some monkey will sleep IDENT	will
our elephant will sleep	our elephant will sleep IDENT	will
my cat would read	my cat would read IDENT	would
our bird will laugh	our bird will laugh IDENT	will
your dogs would read	your dogs would read IDENT	would
the yaks can smile	the yaks can smile IDENT	can
your yak can giggle	your yak can giggle IDENT	can
your yak can smile	your yak can smile IDENT	can
our seal would giggle	our seal would giggle IDENT	would
my dogs would laugh	my dogs would laugh IDENT	would
her seals would smile	her seals would smile IDENT	would
her rabbit can laugh	her rabbit can laugh IDENT	can
the rabbits could read	the rabbits could read IDENT	could
the monkeys can laugh	the monkeys can laugh IDENT	can
my unicorns will laugh	my unicorns will laugh IDENT	will
our bird can laugh	our bird can laugh IDENT	can
our dogs can sleep	our dogs can sleep IDENT	can
her rabbit could read	her rabbit could read IDENT	could
the seal could live	the seal could live IDENT	could
my monkey would read	my monkey would read IDENT	would
the seal can laugh	the seal can laugh IDENT	can
some cat would laugh	some cat would laugh IDENT	would
your yak could live	your yak could live IDENT	could
her cat could laugh	her cat could laugh IDENT	could
the unicorns will sleep	the unicorns will sleep IDENT	will
our unicorns will laugh	our unicorns will laugh IDENT	will
our bird would sleep	our bird would sleep IDENT	would
her yaks would smile	her yaks would smile IDENT	would
our dogs could sleep	our dogs could sleep IDENT	could
her seals could read	her seals could read IDENT	could
our rabbits would sleep	our rabbits would sleep IDENT	would
her cats would read	her cats would read IDENT	would
the unicorn could live	the unicorn could live IDENT	could
her monkey will laugh	her monkey will laugh IDENT	will
my cat could live	my cat could live IDENT	could
her unicorn can giggle	her unicorn can giggle IDENT	can
my bird can laugh	my bird can laugh IDENT	can
our dog could sleep	our dog could sleep IDENT	could
our unicorns would laugh	our unicorns would laugh IDENT	would
her yaks can read	her yaks can read IDENT	can
your bird could live	your bird could live IDENT	could
our cat will read	our cat will read IDENT	will
some unicorns can sleep	some unicorns can sleep IDENT	can
some yak could giggle	some yak could giggle IDENT	could
her rabbits can smile	her rabbits can smile IDENT	can
some birds can read	some birds can read IDENT	can
my monkey will live	my monkey will live IDENT	will
your monkey would giggle	your monkey would giggle IDENT	would
my monkey will sleep	my monkey will sleep IDENT	will
my seals would laugh	my seals would laugh IDENT	would
her cats can read	her cats can read IDENT	can
my rabbit can smile	my rabbit can smile IDENT	can
my unicorns can smile	my unicorns can smile IDENT	can
some monkey would sleep	some monkey would sleep IDENT	would
the yak would read	the yak would read IDENT	would
some yak would live	some yak would live IDENT	would
some bird could read	some bird could read IDENT	could
her unicorn could live	her unicorn could live IDENT	could
the bird would live	the bird would live IDENT	would
the unicorns would laugh	the unicorns would laugh IDENT	would
your unicorn can read	your unicorn can read IDENT	can
her cat would giggle	her cat would giggle IDENT	would
our seal can laugh	our seal can laugh IDENT	can
the dog will giggle	the dog will giggle IDENT	will
the birds will giggle	the birds will giggle IDENT	will
your birds can laugh	your birds can laugh IDENT	can
some monkeys would smile	some monkeys would smile IDENT	would
the unicorn would laugh	the unicorn would laugh IDENT	would
our yaks can laugh	our yaks can laugh IDENT	can
your cats could giggle	your cats could giggle IDENT	could
your rabbits could live	your rabbits could live IDENT	could
the seals can read	the seals can read IDENT	can
the cat can laugh	the cat can laugh IDENT	can
our yaks could read	our yaks could read IDENT	could
your birds can giggle	your birds can giggle IDENT	can
your dogs could sleep	your dogs could sleep IDENT	could
my yaks would smile	my yaks would smile IDENT	would
her yak will giggle	her yak will giggle IDENT	will
my seal could laugh	my seal could laugh IDENT	could
our bird can live	our bird can live IDENT	can
some dog could giggle	some dog could giggle IDENT	could
the dogs can laugh	the dogs can laugh IDENT	can
our cats could giggle	our cats could giggle IDENT	could
her cat could laugh	her cat could laugh IDENT	could
my monkey could read	my monkey could read IDENT	could
some bird can live	some bird can live IDENT	can
your birds will sleep	your birds will sleep IDENT	will
my elephants would sleep	my elephants would sleep IDENT	would
our cat would smile	our cat would smile IDENT	would
some unicorn would giggle	some unicorn would giggle IDENT	would
your elephants can smile	your elephants can smile IDENT	can
the rabbits would read	the rabbits would read IDENT	would
your bird could sleep	your bird could sleep IDENT	could
her elephant would sleep	her elephant would sleep IDENT	would
your rabbits would live	your rabbits would live IDENT	would
her rabbit will giggle	her rabbit will giggle IDENT	will
my rabbits can smile	my rabbits can smile IDENT	can
your unicorns could smile	your unicorns could smile IDENT	could
some unicorns can laugh	some unicorns can laugh IDENT	can
her cats could sleep	her cats could sleep IDENT	could
our unicorns could giggle	our unicorns could giggle IDENT	could
my yaks can sleep	my yaks can sleep IDENT	can
the seals can sleep	the seals can sleep IDENT	can
the yak can live	the yak can live IDENT	can
some rabbit can sleep	some rabbit can sleep IDENT	can
my seal will smile	my seal will smile IDENT	will
our bird could read	our bird could read IDENT	could
my rabbits could sleep	my rabbits could sleep IDENT	could
your seals would live	your seals would live IDENT	would
the yak can read	the yak can read IDENT	can
the rabbits can read	the rabbits can read IDENT	can
her rabbits would giggle	her rabbits would giggle IDENT	would
some monkey can laugh	some monkey can laugh IDENT	can
the yak would giggle	the yak would giggle IDENT	would
your yaks would sleep	your yaks would sleep IDENT	would
your elephants would giggle	your elephants would giggle IDENT	would
the unicorns could smile	the unicorns could smile IDENT	could
your unicorn will giggle	your unicorn will giggle IDENT	will
some bird would laugh	some bird would laugh IDENT	would
some seals would laugh	some seals would laugh IDENT	would
our monkeys could live	our monkeys could live IDENT	could
my dogs will laugh	my dogs will laugh IDENT	will
some monkeys would smile	some monkeys would smile IDENT	would
our cat could read	our cat could read IDENT	could
our cat can giggle	our cat can giggle IDENT	can
the dogs could read	the dogs could read IDENT	could
our elephant will giggle	our elephant will giggle IDENT	will
your yak would sleep	your yak would sleep IDENT	would
her dogs could live	her dogs could live IDENT	could
her elephant will smile	her elephant will smile IDENT	will
my yaks can live	my yaks can live IDENT	can
our rabbits could live	our rabbits could live IDENT	could
some rabbit would sleep	some rabbit would sleep IDENT	would
my bird can sleep	my bird can sleep IDENT	can
our unicorns could giggle	our unicorns could giggle IDENT	could
her seal can live	her seal can live IDENT	can
some bird can live	some bird can live IDENT	can
our dog will giggle	our dog will giggle IDENT	will
the seal can live	the seal can live IDENT	can
her birds will laugh	her birds will laugh IDENT	will
some monkeys would live	some monkeys would live IDENT	would
our yaks could laugh	our yaks could laugh IDENT	could
our rabbits will smile	our rabbits will smile IDENT	will
some elephant would smile	some elephant would smile IDENT	would
her elephant could laugh	her elephant could laugh IDENT	could
some unicorn will smile	some unicorn will smile IDENT	will
your bird will giggle	your bird will giggle IDENT	will
her seal would giggle	her seal would giggle IDENT	would
some seals could smile	some seals could smile IDENT	could
some rabbit could smile	some rabbit could smile IDENT	could
her seals can sleep	her seals can sleep IDENT	can
her unicorns can live	her unicorns can live IDENT	can
our yak could read	our yak could read IDENT	could
her elephant can sleep	her elephant can sleep IDENT	can
her monkeys can sleep	her monkeys can sleep IDENT	can
some bird will sleep	some bird will sleep IDENT	will
our monkey can smile	our monkey can smile IDENT	can
my seals will giggle	my seals will giggle IDENT	will
our yaks would sleep	our yaks would sleep IDENT	would
your monkeys would giggle	your monkeys would giggle IDENT	would
some birds could read	some birds could read IDENT	could
some elephant will read	some elephant will read IDENT	will
the monkey will laugh	the monkey will laugh IDENT	will
some unicorn could read	some unicorn could read IDENT	could
your cat will giggle	your cat will giggle IDENT	will
her seals can read	her seals can read IDENT	can
our seal will read	our seal will read IDENT	will
some unicorns will giggle	some unicorns will giggle IDENT	will
the yak could live	the yak could live IDENT	could
the cats will live	the cats will live IDENT	will
some cat would sleep	some cat would sleep IDENT	would
our monkeys can live	our monkeys can live IDENT	can
her elephants could smile	her elephants could smile IDENT	could
some yaks could giggle	some yaks could giggle IDENT	could
your bird could laugh	your bird could laugh IDENT	could
some birds could read	some birds could read IDENT	could
your cats will sleep	your cats will sleep IDENT	will
some yaks could live	some yaks could live IDENT	could
the yaks can live	the yaks can live IDENT	can
some seals could laugh	some seals could laugh IDENT	could
our seal will live	our seal will live IDENT	will
your monkeys can smile	your monkeys can smile IDENT	can
your dog will smile	your dog will smile IDENT	will
our unicorn will giggle	our unicorn will giggle IDENT	will
your unicorn could live	your unicorn could live IDENT	could
our rabbit would laugh	our rabbit would laugh IDENT	would
my birds will read	my birds will read IDENT	will
some rabbit can laugh	some rabbit can laugh IDENT	can
our rabbit could live	our rabbit could live IDENT	could
her seals would giggle	her seals would giggle IDENT	would
your cat could read	your cat could read IDENT	could
her rabbit could sleep	her rabbit could sleep IDENT	could
her dog could sleep	her dog could sleep IDENT	could
her rabbit will laugh	her rabbit will laugh IDENT	will
our elephant would giggle	our elephant would giggle IDENT	would
my unicorns will giggle	my unicorns will giggle IDENT	will
our unicorn can sleep	our unicorn can sleep IDENT	can
the birds would giggle	the birds would giggle IDENT	would
the unicorn could giggle	the unicorn could giggle IDENT	could
her cat will read	her cat will read IDENT	will
her monkeys could sleep	her monkeys could sleep IDENT	could
her seal can sleep	her seal can sleep IDENT	can
your monkey can read	your monkey can read IDENT	can
your monkey could sleep	your monkey could sleep IDENT	could
the bird will laugh	the bird will laugh IDENT	will
your unicorn can smile	your unicorn can smile IDENT	can
the bird will live	the bird will live IDENT	will
your yak would live	your yak would live IDENT	would
our unicorn could giggle	our unicorn could giggle IDENT	could
your seals can read	your seals can read IDENT	can
your rabbits would live	your rabbits would live IDENT	would
some unicorn can live	some unicorn can live IDENT	can
my cat would read	my cat would read IDENT	would
her monkey would laugh	her monkey would laugh IDENT	would
your unicorns would live	your unicorns would live IDENT	would
your yaks would giggle	your yaks would giggle IDENT	would
some cats will giggle	some cats will giggle IDENT	will
our rabbits would giggle	our rabbits would giggle IDENT	would
her bird would sleep	her bird would sleep IDENT	would
your seal will live	your seal will live IDENT	will
your rabbits will live	your rabbits will live IDENT	will
your seals will laugh	your seals will laugh IDENT	will
some monkeys can read	some monkeys can read IDENT	can
the unicorns will read	the unicorns will read IDENT	will
your seal can giggle	your seal can giggle IDENT	can
our cats would giggle	our cats would giggle IDENT	would
the elephants can laugh	the elephants can laugh IDENT	can
some unicorn could live	some unicorn could live IDENT	could
some bird could sleep	some bird could sleep IDENT	could
my rabbits could live	my rabbits could live IDENT	could
some unicorns can read	some unicorns can read IDENT	can
our rabbits could giggle	our rabbits could giggle IDENT	could
our yak will read	our yak will read IDENT	will
the birds can giggle	the birds can giggle IDENT	can
the dogs can giggle	the dogs can giggle IDENT	can
my dogs will smile	my dogs will smile IDENT	will
the birds could giggle	the birds could giggle IDENT	could
our dog would live	our dog would live IDENT	would
your elephants would giggle	your elephants would giggle IDENT	would
some elephant can live	some elephant can live IDENT	can
our unicorn would sleep	our unicorn would sleep IDENT	would
her birds can laugh	her birds can laugh IDENT	can
your rabbits could smile	your rabbits could smile IDENT	could
my cat could read	my cat could read IDENT	could
some dogs can laugh	some dogs can laugh IDENT	can
our rabbit could read	our rabbit could read IDENT	could
our monkey could sleep	our monkey could sleep IDENT	could
her dogs would sleep	her dogs would sleep IDENT	would
her bird would sleep	her bird would sleep IDENT	would
my unicorn can smile	my unicorn can smile IDENT	can
the birds would laugh	the birds would laugh IDENT	would
our birds would read	our birds would read IDENT	would
my elephant could laugh	my elephant could laugh IDENT	could
our elephants would live	our elephants would live IDENT	would
your elephant would giggle	your elephant would giggle IDENT	would
my birds will sleep	my birds will sleep IDENT	will
some rabbit could sleep	some rabbit could sleep IDENT	could
our unicorns could smile	our unicorns could smile IDENT	could
the elephants can sleep	the elephants can sleep IDENT	can
her unicorns would laugh	her unicorns would laugh IDENT	would
our unicorns could live	our unicorns could live IDENT	could
my dogs will laugh	my dogs will laugh IDENT	will
our rabbits could laugh	our rabbits could laugh IDENT	could
your yaks could laugh	your yaks could laugh IDENT	could
your yaks can live	your yaks can live IDENT	can
some elephants could sleep	some elephants could sleep IDENT	could
some elephant will laugh	some elephant will laugh IDENT	will
her monkeys will giggle	her monkeys will giggle IDENT	will
our yak would read	our yak would read IDENT	would
the birds will smile	the birds will smile IDENT	will
her cat can read	her cat can read IDENT	can
my seal would giggle	my seal would giggle IDENT	would
the yak can read	the yak can read IDENT	can
my elephant can smile	my elephant can smile IDENT	can
her cat can giggle	her cat can giggle IDENT	can
her cat can live	her cat can live IDENT	can
her yaks will giggle	her yaks will giggle IDENT	will
our unicorn would sleep	our unicorn would sleep IDENT	would
your unicorn would laugh	your unicorn would laugh IDENT	would
my bird would read	my bird would read IDENT	would
your seal could laugh	your seal could laugh IDENT	could
your seal could read	your seal could read IDENT	could
my bird would live	my bird would live IDENT	would
some elephant would giggle	some elephant would giggle IDENT	would
your unicorns could smile	your unicorns could smile IDENT	could
our elephants will read	our elephants will read IDENT	will
your seals can read	your seals can read IDENT	can
some yaks will read	some yaks will read IDENT	will
her yaks will laugh	her yaks will laugh IDENT	will
her birds can read	her birds can read IDENT	can
my rabbits could read	my rabbits could read IDENT	could
the unicorn can giggle	the unicorn can giggle IDENT	can
the monkey would giggle	the monkey would giggle IDENT	would
my unicorn can smile	my unicorn can smile IDENT	can
our cat will read	our cat will read IDENT	will
your elephant would laugh	your elephant would laugh IDENT	would
my monkey can giggle	my monkey can giggle IDENT	can
your monkey could laugh	your monkey could laugh IDENT	could
some elephant could read	some elephant could read IDENT	could
some rabbits will live	some rabbits will live IDENT	will
our birds would live	our birds would live IDENT	would
your seals can giggle	your seals can giggle IDENT	can
your yak could laugh	your yak could laugh IDENT	could
my monkeys would giggle	my monkeys would giggle IDENT	would
my seal would giggle	my seal would giggle IDENT	would
your unicorns can read	your unicorns can read IDENT	can
your unicorns could read	your unicorns could read IDENT	could
some yak will giggle	some yak will giggle IDENT	will
the bird would smile	the bird would smile IDENT	would
our rabbit can laugh	our rabbit can laugh IDENT	can
my birds would sleep	my birds would sleep IDENT	would
her yaks can sleep	her yaks can sleep IDENT	can
your elephants can read	your elephants can read IDENT	can
our birds could sleep	our birds could sleep IDENT	could
the dog would giggle	the dog would giggle IDENT	would
some monkeys can live	some monkeys can live IDENT	can
your cats could sleep	your cats could sleep IDENT	could
the seal would read	the seal would read IDENT	would
the yak will read	the yak will read IDENT	will
our seal would read	our seal would read IDENT	would
the monkeys can live	the monkeys can live IDENT	can
our unicorns would giggle	our unicorns would giggle IDENT	would
some yak can read	some yak can read IDENT	can
your dog will sleep	your dog will sleep IDENT	will
her elephants would smile	her elephants would smile IDENT	would
some yak could laugh	some yak could laugh IDENT	could
our elephant could read	our elephant could read IDENT	could
our yaks can sleep	our yaks can sleep IDENT	can
our monkey can read	our monkey can read IDENT	can
our monkey can giggle	our monkey can giggle IDENT	can
my dog could live	my dog could live IDENT	could
our seal will sleep	our seal will sleep IDENT	will
your yaks would read	your yaks would read IDENT	would
some seal could giggle	some seal could giggle IDENT	could
the bird can smile	the bird can smile IDENT	can
her seal can live	her seal can live IDENT	can
my bird would read	my bird would read IDENT	would
your dogs can live	your dogs can live IDENT	can
her cats will giggle	her cats will giggle IDENT	will
the rabbits will sleep	the rabbits will sleep IDENT	will
your seal could smile	your seal could smile IDENT	could
your yak will laugh	your yak will laugh IDENT	will
your seal could read	your seal could read IDENT	could
some unicorns will sleep	some unicorns will sleep IDENT	will
your elephant would read	your elephant would read IDENT	would
your unicorn would giggle	your unicorn would giggle IDENT	would
her unicorn can smile	her unicorn can smile IDENT	can
our seal would smile	our seal would smile IDENT	would
our dog would giggle	our dog would giggle IDENT	would
my dog would smile	my dog would smile IDENT	would
some seal could sleep	some seal could sleep IDENT	could
our elephants can giggle	our elephants can giggle IDENT	can
some monkey can giggle	some monkey can giggle IDENT	can
some cats would laugh	some cats would laugh IDENT	would
the elephants could giggle	the elephants could giggle IDENT	could
the elephants would live	the elephants would live IDENT	would
her bird could live	her bird could live IDENT	could
my monkey would read	my monkey would read IDENT	would
your elephant could read	your elephant could read IDENT	could
our rabbit could laugh	our rabbit could laugh IDENT	could
our yaks could live	our yaks could live IDENT	could
some monkey will smile	some monkey will smile IDENT	will
the seal would live	the seal would live IDENT	would
the rabbits will smile	the rabbits will smile IDENT	will
some bird can laugh	some bird can laugh IDENT	can
the yak would live	the yak would live IDENT	would
your unicorns would read	your unicorns would read IDENT	would
your elephant would read	your elephant would read IDENT	would
your elephant could live	your elephant could live IDENT	could
our cats would read	our cats would read IDENT	would
some rabbits could sleep	some rabbits could sleep IDENT	could
her rabbits could read	her rabbits could read IDENT	could
your monkeys will read	your monkeys will read IDENT	will
our yak will giggle	our yak will giggle IDENT	will
some dog will read	some dog will read IDENT	will
her dog can smile	her dog can smile IDENT	can
her rabbit can live	her rabbit can live IDENT	can
our monkey can live	our monkey can live IDENT	can
our monkey can laugh	our monkey can laugh IDENT	can
the rabbits could laugh	the rabbits could laugh IDENT	could
the dog would live	the dog would live IDENT	would
the dog can live	the dog can live IDENT	can
some yaks will giggle	some yaks will giggle IDENT	will
some yaks will read	some yaks will read IDENT	will
some seals could laugh	some seals could laugh IDENT	could
my rabbit would read	my rabbit would read IDENT	would
my yak would read	my yak would read IDENT	would
our yaks can laugh	our yaks can laugh IDENT	can
your rabbit could giggle	your rabbit could giggle IDENT	could
the elephant will laugh	the elephant will laugh IDENT	will
my seals will live	my seals will live IDENT	will
my seal can giggle	my seal can giggle IDENT	can
the dogs could sleep	the dogs could sleep IDENT	could
your birds would giggle	your birds would giggle IDENT	would
my monkeys will giggle	my monkeys will giggle IDENT	will
some rabbits would laugh	some rabbits would laugh IDENT	would
our monkey would laugh	our monkey would laugh IDENT	would
the seals can read	the seals can read IDENT	can
some elephant will laugh	some elephant will laugh IDENT	will
her elephant can laugh	her elephant can laugh IDENT	can
your unicorns will laugh	your unicorns will laugh IDENT	will
her unicorn will live	her unicorn will live IDENT	will
your seal would live	your seal would live IDENT	would
your dog would giggle	your dog would giggle IDENT	would
the yaks could read	the yaks could read IDENT	could
my seals can laugh	my seals can laugh IDENT	can
her unicorns will smile	her unicorns will smile IDENT	will
our seal would live	our seal would live IDENT	would
your bird would giggle	your bird would giggle IDENT	would
some seals could laugh	some seals could laugh IDENT	could
some bird will giggle	some bird will giggle IDENT	will
her seals will giggle	her seals will giggle IDENT	will
the dog could giggle	the dog could giggle IDENT	could
the dogs would smile	the dogs would smile IDENT	would
your elephants will live	your elephants will live IDENT	will
the seal can sleep	the seal can sleep IDENT	can
her cats will smile	her cats will smile IDENT	will
our unicorn can giggle	our unicorn can giggle IDENT	can
our bird can sleep	our bird can sleep IDENT	can
her unicorn would read	her unicorn would read IDENT	would
her seal would read	her seal would read IDENT	would
the yak could read	the yak could read IDENT	could
the elephant would giggle	the elephant would giggle IDENT	would
your elephant would sleep	your elephant would sleep IDENT	would
her rabbit could laugh	her rabbit could laugh IDENT	could
some bird would smile	some bird would smile IDENT	would
the bird would live	the bird would live IDENT	would
my monkey can smile	my monkey can smile IDENT	can
your unicorn can sleep	your unicorn can sleep IDENT	can
your rabbit could live	your rabbit could live IDENT	could
her monkeys would live	her monkeys would live IDENT	would
your seals can giggle	your seals can giggle IDENT	can
our rabbits can giggle	our rabbits can giggle IDENT	can
some monkeys will sleep	some monkeys will sleep IDENT	will
our dog could giggle	our dog could giggle IDENT	could
some cat would giggle	some cat would giggle IDENT	would
the cat will laugh	the cat will laugh IDENT	will
her dog will read	her dog will read IDENT	will
your bird can read	your bird can read IDENT	can
the rabbits could giggle	the rabbits could giggle IDENT	could
your monkey can sleep	your monkey can sleep IDENT	can
our seal will read	our seal will read IDENT	will
our cats would read	our cats would read IDENT	would
our rabbits can read	our rabbits can read IDENT	can
the unicorn can smile	the unicorn can smile IDENT	can
her yaks can live	her yaks can live IDENT	can
her dogs would smile	her dogs would smile IDENT	would
the yak can live	the yak can live IDENT	can
the dog will laugh	the dog will laugh IDENT	will
some monkeys could laugh	some monkeys could laugh IDENT	could
our yak will read	our yak will read IDENT	will
our cats can live	our cats can live IDENT	can
her dogs would read	her dogs would read IDENT	would
our monkey could read	our monkey could read IDENT	could
my unicorn can sleep	my unicorn can sleep IDENT	can
my dogs will sleep	my dogs will sleep IDENT	will
your monkey could sleep	your monkey could sleep IDENT	could
your monkey could smile	your monkey could smile IDENT	could
your yak could laugh	your yak could laugh IDENT	could
your elephant could sleep	your elephant could sleep IDENT	could
your yak will smile	your yak will smile IDENT	will
my bird would laugh	my bird would laugh IDENT	would
the dog could smile	the dog could smile IDENT	could
my yaks can giggle	my yaks can giggle IDENT	can
the cats would sleep	the cats would sleep IDENT	would
our dogs will laugh	our dogs will laugh IDENT	will
some rabbit could read	some rabbit could read IDENT	could
the monkey can giggle	the monkey can giggle IDENT	can
her bird could read	her bird could read IDENT	could
the seals would laugh	the seals would laugh IDENT	would
our rabbits will live	our rabbits will live IDENT	will
some rabbits can live	some rabbits can live IDENT	can
some yaks will live	some yaks will live IDENT	will
the dog could live	the dog could live IDENT	could
her cats would laugh	her cats would laugh IDENT	would
your seals can laugh	your seals can laugh IDENT	can
some rabbit can sleep	some rabbit can sleep IDENT	can
some seal can read	some seal can read IDENT	can
your monkey could laugh	your monkey could laugh IDENT	could
her bird could laugh	her bird could laugh IDENT	could
our cats can giggle	our cats can giggle IDENT	can
some seal will laugh	some seal will laugh IDENT	will
my birds would live	my birds would live IDENT	would
some unicorns could sleep	some unicorns could sleep IDENT	could
some cats could giggle	some cats could giggle IDENT	could
some yaks will read	some yaks will read IDENT	will
our bird can read	our bird can read IDENT	can
the bird would laugh	the bird would laugh IDENT	would
our unicorns would laugh	our unicorns would laugh IDENT	would
some elephant could giggle	some elephant could giggle IDENT	could
our seal will giggle	our seal will giggle IDENT	will
our birds can laugh	our birds can laugh IDENT	can
some cat will read	some cat will read IDENT	will
your cats would giggle	your cats would giggle IDENT	would
some birds can laugh	some birds can laugh IDENT	can
your dogs would smile	your dogs would smile IDENT	would
my dogs will smile	my dogs will smile IDENT	will
my seals can live	my seals can live IDENT	can
the monkey could laugh	the monkey could laugh IDENT	could
your monkeys could sleep	your monkeys could sleep IDENT	could
the dog will live	the dog will live IDENT	will
the monkey could live	the monkey could live IDENT	could
our seal could read	our seal could read IDENT	could
some seals would read	some seals would read IDENT	would
the seals will sleep	the seals will sleep IDENT	will
her rabbits could smile	her rabbits could smile IDENT	could
the unicorn could smile	the unicorn could smile IDENT	could
her seal would live	her seal would live IDENT	would
the seals would read	the seals would read IDENT	would
some yak would smile	some yak would smile IDENT	would
some cats can giggle	some cats can giggle IDENT	can
our rabbit would sleep	our rabbit would sleep IDENT	would
the unicorns will smile	the unicorns will smile IDENT	will
your cats can sleep	your cats can sleep IDENT	can
your dogs would live	your dogs would live IDENT	would
my unicorns could sleep	my unicorns could sleep IDENT	could
our cat will laugh	our cat will laugh IDENT	will
some birds will sleep	some birds will sleep IDENT	will
our seal will giggle	our seal will giggle IDENT	will
your yak can read	your yak can read IDENT	can
the seals would giggle	the seals would giggle IDENT	would
our seal would giggle	our seal would giggle IDENT	would
her elephant will live	her elephant will live IDENT	will
our birds will read	our birds will read IDENT	will
some elephants can giggle	some elephants can giggle IDENT	can
the yaks could read	the yaks could read IDENT	could
our seals could live	our seals could live IDENT	could
your seal could smile	your seal could smile IDENT	could
our yak would smile	our yak would smile IDENT	would
her rabbit will sleep	her rabbit will sleep IDENT	will
our bird could sleep	our bird could sleep IDENT	could
her dog could sleep	her dog could sleep IDENT	could
the elephants could sleep	the elephants could sleep IDENT	could
the rabbits would laugh	the rabbits would laugh IDENT	would
her elephants would sleep	her elephants would sleep IDENT	would
her seal could read	her seal could read IDENT	could
my elephant would read	my elephant would read IDENT	would
her unicorn would live	her unicorn would live IDENT	would
some bird could read	some bird could read IDENT	could
some rabbit could live	some rabbit could live IDENT	could
the birds could giggle	the birds could giggle IDENT	could
my cats would giggle	my cats would giggle IDENT	would
some monkeys will laugh	some monkeys will laugh IDENT	will
your unicorns would read	your unicorns would read IDENT	would
the seals would laugh	the seals would laugh IDENT	would
my rabbit can live	my rabbit can live IDENT	can
our dogs can live	our dogs can live IDENT	can
my yak can read	my yak can read IDENT	can
the elephant can giggle	the elephant can giggle IDENT	can
my seal could giggle	my seal could giggle IDENT	could
her monkeys can laugh	her monkeys can laugh IDENT	can
your monkey could giggle	your monkey could giggle IDENT	could
the bird will smile	the bird will smile IDENT	will
our cat will giggle	our cat will giggle IDENT	will
some elephants would live	some elephants would live IDENT	would
my bird can live	my bird can live IDENT	can
her elephants can giggle	her elephants can giggle IDENT	can
our rabbits would sleep	our rabbits would sleep IDENT	would
some monkey will laugh	some monkey will laugh IDENT	will
our unicorns could live	our unicorns could live IDENT	could
her dog could live	her dog could live IDENT	could
some unicorn can read	some unicorn can read IDENT	can
the unicorn can laugh	the unicorn can laugh IDENT	can
your unicorn can live	your unicorn can live IDENT	can
my unicorns can live	my unicorns can live IDENT	can
the unicorns will giggle	the unicorns will giggle IDENT	will
her monkey would giggle	her monkey would giggle IDENT	would
her monkey could read	her monkey could read IDENT	could
the cats will read	the cats will read IDENT	will
your elephant can read	your elephant can read IDENT	can
your seals would sleep	your seals would sleep IDENT	would
her monkey would live	her monkey would live IDENT	would
her dog could smile	her dog could smile IDENT	could
our dog could read	our dog could read IDENT	could
some seal would read	some seal would read IDENT	would
her unicorns could live	her unicorns could live IDENT	could
our monkeys could read	our monkeys could read IDENT	could
my rabbit could read	my rabbit could read IDENT	could
my unicorns would read	my unicorns would read IDENT	would
her elephants would laugh	her elephants would laugh IDENT	would
the elephant could sleep	the elephant could sleep IDENT	could
the monkey could giggle	the monkey could giggle IDENT	could
the unicorns will live	the unicorns will live IDENT	will
some elephant will read	some elephant will read IDENT	will
your cats could laugh	your cats could laugh IDENT	could
your seals could laugh	your seals could laugh IDENT	could
your seals would read	your seals would read IDENT	would
my elephants can laugh	my elephants can laugh IDENT	can
your bird would giggle	your bird would giggle IDENT	would
our elephant could live	our elephant could live IDENT	could
the cat would sleep	the cat would sleep IDENT	would
the bird will giggle	the bird will giggle IDENT	will
our bird will giggle	our bird will giggle IDENT	will
your dogs will read	your dogs will read IDENT	will
my monkeys can sleep	my monkeys can sleep IDENT	can
my rabbits could laugh	my rabbits could laugh IDENT	could
her cats will giggle	her cats will giggle IDENT	will
some unicorns would read	some unicorns would read IDENT	would
your dogs could sleep	your dogs could sleep IDENT	could
my monkeys will sleep	my monkeys will sleep IDENT	will
your unicorn can smile	your unicorn can smile IDENT	can
her unicorns will smile	her unicorns will smile IDENT	will
our monkey could laugh	our monkey could laugh IDENT	could
her monkeys would live	her monkeys would live IDENT	would
the cats could read	the cats could read IDENT	could
your dogs would read	your dogs would read IDENT	would
your bird can smile	your bird can smile IDENT	can
some rabbits would giggle	some rabbits would giggle IDENT	would
some monkeys would smile	some monkeys would smile IDENT	would
the monkey would sleep	the monkey would sleep IDENT	would
our cats will laugh	our cats will laugh IDENT	will
the birds can read	the birds can read IDENT	can
her birds would read	her birds would read IDENT	would
our rabbits can read	our rabbits can read IDENT	can
my cats can live	my cats can live IDENT	can
our birds would smile	our birds would smile IDENT	would
our yaks would giggle	our yaks would giggle IDENT	would
your seals will giggle	your seals will giggle IDENT	will
some seal could sleep	some seal could sleep IDENT	could
our rabbit can giggle	our rabbit can giggle IDENT	can
our cats could smile	our cats could smile IDENT	could
the yaks could smile	the yaks could smile IDENT	could
my cat can smile	my cat can smile IDENT	can
your monkey will smile	your monkey will smile IDENT	will
the monkey will smile	the monkey will smile IDENT	will
the birds will sleep	the birds will sleep IDENT	will
some seal will sleep	some seal will sleep IDENT	will
her yaks will live	her yaks will live IDENT	will
her dog could read	her dog could read IDENT	could
my seals could giggle	my seals could giggle IDENT	could
her seals could laugh	her seals could laugh IDENT	could
her yak will laugh	her yak will laugh IDENT	will
your monkeys will read	your monkeys will read IDENT	will
my elephants will live	my elephants will live IDENT	will
her rabbits would live	her rabbits would live IDENT	would
your cats will live	your cats will live IDENT	will
the cats can giggle	the cats can giggle IDENT	can
her dogs can sleep	her dogs can sleep IDENT	can
our cat can giggle	our cat can giggle IDENT	can
our dog will smile	our dog will smile IDENT	will
the cat could sleep	the cat could sleep IDENT	could
her seal could smile	her seal could smile IDENT	could
your unicorn could read	your unicorn could read IDENT	could
your unicorn would read	your unicorn would read IDENT	would
her rabbit can giggle	her rabbit can giggle IDENT	can
some rabbits could live	some rabbits could live IDENT	could
our elephants can smile	our elephants can smile IDENT	can
my elephant could giggle	my elephant could giggle IDENT	could
my elephant can live	my elephant can live IDENT	can
my elephant would read	my elephant would read IDENT	would
some dogs would read	some dogs would read IDENT	would
some bird would live	some bird would live IDENT	would
my elephants will smile	my elephants will smile IDENT	will
some rabbits will live	some rabbits will live IDENT	will
some seal will giggle	some seal will giggle IDENT	will
some dogs will laugh	some dogs will laugh IDENT	will
her dogs can sleep	her dogs can sleep IDENT	can
the cat will laugh	the cat will laugh IDENT	will
her bird can giggle	her bird can giggle IDENT	can
some unicorn can laugh	some unicorn can laugh IDENT	can
our bird can smile	our bird can smile IDENT	can
your monkey would sleep	your monkey would sleep IDENT	would
my unicorn can laugh	my unicorn can laugh IDENT	can
her rabbit could laugh	her rabbit could laugh IDENT	could
some elephant would smile	some elephant would smile IDENT	would
your rabbit could live	your rabbit could live IDENT	could
your rabbit could laugh	your rabbit could laugh IDENT	could
my unicorn will smile	my unicorn will smile IDENT	will
my unicorns can smile	my unicorns can smile IDENT	can
the monkey will read	the monkey will read IDENT	will
some yaks can laugh	some yaks can laugh IDENT	can
your seals will smile	your seals will smile IDENT	will
the seals would laugh	the seals would laugh IDENT	would
my seals will live	my seals will live IDENT	will
some rabbits can read	some rabbits can read IDENT	can
the cat can live	the cat can live IDENT	can
your seals will sleep	your seals will sleep IDENT	will
her dog will giggle	her dog will giggle IDENT	will
her cat can live	her cat can live IDENT	can
my yaks will sleep	my yaks will sleep IDENT	will
my yaks would laugh	my yaks would laugh IDENT	would
some elephants would read	some elephants would read IDENT	would
some yak could sleep	some yak could sleep IDENT	could
my unicorn will sleep	my unicorn will sleep IDENT	will
my dogs can sleep	my dogs can sleep IDENT	can
my unicorns could sleep	my unicorns could sleep IDENT	could
some bird would live	some bird would live IDENT	would
my monkeys would giggle	my monkeys would giggle IDENT	would
your bird could smile	your bird could smile IDENT	could
our monkey could live	our monkey could live IDENT	could
my unicorn will live	my unicorn will live IDENT	will
our monkeys can laugh	our monkeys can laugh IDENT	can
the unicorn will smile	the unicorn will smile IDENT	will
some dogs could sleep	some dogs could sleep IDENT	could
your monkeys can smile	your monkeys can smile IDENT	can
my cat would read	my cat would read IDENT	would
our yak could sleep	our yak could sleep IDENT	could
the elephants could live	the elephants could live IDENT	could
her cats would giggle	her cats would giggle IDENT	would
her yak will giggle	her yak will giggle IDENT	will
our birds will laugh	our birds will laugh IDENT	will
the unicorn will read	the unicorn will read IDENT	will
the dog can read	the dog can read IDENT	can
the cats will read	the cats will read IDENT	will
the monkeys will giggle	the monkeys will giggle IDENT	will
my yaks can live	my yaks can live IDENT	can
the cat will read	the cat will read IDENT	will
our dogs could sleep	our dogs could sleep IDENT	could
the dogs could sleep	the dogs could sleep IDENT	could
some elephant will laugh	some elephant will laugh IDENT	will
some elephants could sleep	some elephants could sleep IDENT	could
her rabbit will read	her rabbit will read IDENT	will
the cat would giggle	the cat would giggle IDENT	would
my yaks could sleep	my yaks could sleep IDENT	could
our unicorns will smile	our unicorns will smile IDENT	will
the monkey will smile	the monkey will smile IDENT	will
my elephant can laugh	my elephant can laugh IDENT	can
her yaks will read	her yaks will read IDENT	will
her monkeys will live	her monkeys will live IDENT	will
my unicorns would sleep	my unicorns would sleep IDENT	would
her seal could read	her seal could read IDENT	could
her unicorn can read	her unicorn can read IDENT	can
her rabbits would laugh	her rabbits would laugh IDENT	would
your yaks can laugh	your yaks can laugh IDENT	can
the seal would giggle	the seal would giggle IDENT	would
my seal could sleep	my seal could sleep IDENT	could
her monkey will sleep	her monkey will sleep IDENT	will
the rabbits would sleep	the rabbits would sleep IDENT	would
my yaks would smile	my yaks would smile IDENT	would
our bird can read	our bird can read IDENT	can
some seals would giggle	some seals would giggle IDENT	would
the cats could sleep	the cats could sleep IDENT	could
your elephant would smile	your elephant would smile IDENT	would
my rabbit can giggle	my rabbit can giggle IDENT	can
your monkeys would giggle	your monkeys would giggle IDENT	would
your monkeys could giggle	your monkeys could giggle IDENT	could
the seal can smile	the seal can smile IDENT	can
her seals could live	her seals could live IDENT	could
your dogs would laugh	your dogs would laugh IDENT	would
your rabbit can sleep	your rabbit can sleep IDENT	can
our birds would smile	our birds would smile IDENT	would
some rabbit would giggle	some rabbit would giggle IDENT	would
our bird could smile	our bird could smile IDENT	could
some dog will giggle	some dog will giggle IDENT	will
your unicorn could read	your unicorn could read IDENT	could
some unicorn would read	some unicorn would read IDENT	would
the birds can laugh	the birds can laugh IDENT	can
some monkey would smile	some monkey would smile IDENT	would
your rabbit would giggle	your rabbit would giggle IDENT	would
my elephants would live	my elephants would live IDENT	would
my seals can smile	my seals can smile IDENT	can
your birds would laugh	your birds would laugh IDENT	would
my dogs can live	my dogs can live IDENT	can
our elephant could smile	our elephant could smile IDENT	could
the cats would read	the cats would read IDENT	would
our birds can read	our birds can read IDENT	can
our unicorns will sleep	our unicorns will sleep IDENT	will
the unicorn could smile	the unicorn could smile IDENT	could
my bird can read	my bird can read IDENT	can
our birds could read	our birds could read IDENT	could
the dog could read	the dog could read IDENT	could
our elephant would laugh	our elephant would laugh IDENT	would
her unicorn will sleep	her unicorn will sleep IDENT	will
our bird can smile	our bird can smile IDENT	can
our bird would read	our bird would read IDENT	would
my monkeys can giggle	my monkeys can giggle IDENT	can
her seals can laugh	her seals can laugh IDENT	can
our unicorns will laugh	our unicorns will laugh IDENT	will
your unicorns will giggle	your unicorns will giggle IDENT	will
some rabbit would smile	some rabbit would smile IDENT	would
your rabbit will live	your rabbit will live IDENT	will
my cats will laugh	my cats will laugh IDENT	will
some seal will smile	some seal will smile IDENT	will
the monkey can laugh	the monkey can laugh IDENT	can
my dogs will live	my dogs will live IDENT	will
our yak could live	our yak could live IDENT	could
our dog could giggle	our dog could giggle IDENT	could
our dog could giggle	our dog could giggle IDENT	could
our dog will giggle	our dog will giggle IDENT	will
your seal can read	your seal can read IDENT	can
your monkey will read	your monkey will read IDENT	will
your cat could sleep	your cat could sleep IDENT	could
some birds will laugh	some birds will laugh IDENT	will
my dog could sleep	my dog could sleep IDENT	could
my bird will giggle	my bird will giggle IDENT	will
your monkeys would giggle	your monkeys would giggle IDENT	would
your birds would sleep	your birds would sleep IDENT	would
some cat could giggle	some cat could giggle IDENT	could
some yak can read	some yak can read IDENT	can
our rabbits could sleep	our rabbits could sleep IDENT	could
your yaks could giggle	your yaks could giggle IDENT	could
our dogs could live	our dogs could live IDENT	could
the elephants could sleep	the elephants could sleep IDENT	could
the elephants would sleep	the elephants would sleep IDENT	would
some elephants would sleep	some elephants would sleep IDENT	would
your cat will laugh	your cat will laugh IDENT	will
your monkey can laugh	your monkey can laugh IDENT	can
our unicorn will read	our unicorn will read IDENT	will
