our elephant does giggle	our elephant does giggle IDENT	does
my monkeys dont smile	my monkeys dont smile IDENT	dont
the birds do read	the birds do read IDENT	do
our seal doesnt live	our seal doesnt live IDENT	doesnt
our cat doesnt giggle	our cat doesnt giggle IDENT	doesnt
my rabbit doesnt read	my rabbit doesnt read IDENT	doesnt
my unicorns do giggle	my unicorns do giggle IDENT	do
the seal does read	the seal does read IDENT	does
some seals dont smile	some seals dont smile IDENT	dont
our rabbit does live	our rabbit does live IDENT	does
our unicorn does read	our unicorn does read IDENT	does
her yak does sleep	her yak does sleep IDENT	does
the unicorns dont live	the unicorns dont live IDENT	dont
the rabbit doesnt read	the rabbit doesnt read IDENT	doesnt
the monkey does sleep	the monkey does sleep IDENT	does
the cats do read	the cats do read IDENT	do
her rabbit does sleep	her rabbit does sleep IDENT	does
her unicorns do smile	her unicorns do smile IDENT	do
the monkey does read	the monkey does read IDENT	does
the elephants do sleep	the elephants do sleep IDENT	do
our rabbit does laugh	our rabbit does laugh IDENT	does
our unicorn doesnt live	our unicorn doesnt live IDENT	doesnt
our rabbits dont live	our rabbits dont live IDENT	dont
your dog does smile	your dog does smile IDENT	does
my seal doesnt giggle	my seal doesnt giggle IDENT	doesnt
our rabbit does sleep	our rabbit does sleep IDENT	does
your yaks do laugh	your yaks do laugh IDENT	do
your unicorns dont live	your unicorns dont live IDENT	dont
my yak doesnt read	my yak doesnt read IDENT	doesnt
her monkey doesnt laugh	her monkey doesnt laugh IDENT	doesnt
our unicorn does live	our unicorn does live IDENT	does
our bird does sleep	our bird does sleep IDENT	does
our dogs dont live	our dogs dont live IDENT	dont
my cat does smile	my cat does smile IDENT	does
our rabbits do live	our rabbits do live IDENT	do
our dogs do read	our dogs do read IDENT	do
the elephant does giggle	the elephant does giggle IDENT	does
the unicorns do read	the unicorns do read IDENT	do
the monkey doesnt laugh	the monkey doesnt laugh IDENT	doesnt
the monkeys do live	the monkeys do live IDENT	do
our monkeys dont sleep	our monkeys dont sleep IDENT	dont
our unicorn does laugh	our unicorn does laugh IDENT	does
our unicorn doesnt smile	our unicorn doesnt smile IDENT	doesnt
our birds dont smile	our birds dont smile IDENT	dont
your seal doesnt laugh	your seal doesnt laugh IDENT	doesnt
some seal doesnt live	some seal doesnt live IDENT	doesnt
our yak doesnt read	our yak doesnt read IDENT	doesnt
our yaks do read	our yaks do read IDENT	do
some birds dont read	some birds dont read IDENT	dont
my dog does laugh	my dog does laugh IDENT	does
your rabbit does live	your rabbit does live IDENT	does
your bird doesnt live	your bird doesnt live IDENT	doesnt
your rabbits dont read	your rabbits dont read IDENT	dont
her elephants do read	her elephants do read IDENT	do
some elephant doesnt laugh	some elephant doesnt laugh IDENT	doesnt
the cat doesnt laugh	the cat doesnt laugh IDENT	doesnt
some rabbit doesnt laugh	some rabbit doesnt laugh IDENT	doesnt
some bird does smile	some bird does smile IDENT	does
the dog doesnt smile	the dog doesnt smile IDENT	doesnt
some dogs dont laugh	some dogs dont laugh IDENT	dont
our cat doesnt giggle	our cat doesnt giggle IDENT	doesnt
your monkey does live	your monkey does live IDENT	does
your dogs do live	your dogs do live IDENT	do
our seal does live	our seal does live IDENT	does
her unicorn does live	her unicorn does live IDENT	does
your yaks do giggle	your yaks do giggle IDENT	do
the elephants dont giggle	the elephants dont giggle IDENT	dont
her seals dont smile	her seals dont smile IDENT	dont
my bird does live	my bird does live IDENT	does
your cat doesnt live	your cat doesnt live IDENT	doesnt
some rabbit doesnt laugh	some rabbit doesnt laugh IDENT	doesnt
the birds dont live	the birds dont live IDENT	dont
your yak doesnt sleep	your yak doesnt sleep IDENT	doesnt
the bird does giggle	the bird does giggle IDENT	does
some cat does smile	some cat does smile IDENT	does
my elephant does smile	my elephant does smile IDENT	does
your birds do smile	your birds do smile IDENT	do
our elephants do read	our elephants do read IDENT	do
your bird does giggle	your bird does giggle IDENT	does
the unicorn doesnt live	the unicorn doesnt live IDENT	doesnt
your monkeys do sleep	your monkeys do sleep IDENT	do
some dog doesnt sleep	some dog doesnt sleep IDENT	doesnt
some rabbits dont sleep	some rabbits dont sleep IDENT	dont
my unicorns do sleep	my unicorns do sleep IDENT	do
my unicorn does giggle	my unicorn does giggle IDENT	does
the seal doesnt sleep	the seal doesnt sleep IDENT	doesnt
my seal doesnt read	my seal doesnt read IDENT	doesnt
the elephants do laugh	the elephants do laugh IDENT	do
the elephants dont smile	the elephants dont smile IDENT	dont
your bird doesnt read	your bird doesnt read IDENT	doesnt
some birds do read	some birds do read IDENT	do
your birds do read	your birds do read IDENT	do
her elephants dont smile	her elephants dont smile IDENT	dont
my unicorn does laugh	my unicorn does laugh IDENT	does
your dogs dont sleep	your dogs dont sleep IDENT	dont
some elephant doesnt read	some elephant doesnt read IDENT	doesnt
the yaks do laugh	the yaks do laugh IDENT	do
my dogs dont smile	my dogs dont smile IDENT	dont
our cat does smile	our cat does smile IDENT	does
my elephant doesnt smile	my elephant doesnt smile IDENT	doesnt
the bird does read	the bird does read IDENT	does
her dog does giggle	her dog does giggle IDENT	does
your seals do smile	your seals do smile IDENT	do
your seals do laugh	your seals do laugh IDENT	do
some cats dont smile	some cats dont smile IDENT	dont
some unicorn doesnt laugh	some unicorn doesnt laugh IDENT	doesnt
our cats dont giggle	our cats dont giggle IDENT	dont
our birds do giggle	our birds do giggle IDENT	do
our yak does laugh	our yak does laugh IDENT	does
our cats do laugh	our cats do laugh IDENT	do
your elephant doesnt live	your elephant doesnt live IDENT	doesnt
your elephant does read	your elephant does read IDENT	does
your unicorns do live	your unicorns do live IDENT	do
your yaks dont live	your yaks dont live IDENT	dont
the yak doesnt live	the yak doesnt live IDENT	doesnt
her seal doesnt live	her seal doesnt live IDENT	doesnt
some rabbit does laugh	some rabbit does laugh IDENT	does
the cat doesnt read	the cat doesnt read IDENT	doesnt
her elephant doesnt sleep	her elephant doesnt sleep IDENT	doesnt
her seals dont laugh	her seals dont laugh IDENT	dont
the seal doesnt live	the seal doesnt live IDENT	doesnt
your seals do read	your seals do read IDENT	do
my seals do laugh	my seals do laugh IDENT	do
your yak does live	your yak does live IDENT	does
the birds dont giggle	the birds dont giggle IDENT	dont
your cat does sleep	your cat does sleep IDENT	does
our unicorns dont smile	our unicorns dont smile IDENT	dont
my seals do smile	my seals do smile IDENT	do
our cat does laugh	our cat does laugh IDENT	does
some seal doesnt laugh	some seal doesnt laugh IDENT	doesnt
some yak doesnt read	some yak doesnt read IDENT	doesnt
some dogs dont laugh	some dogs dont laugh IDENT	dont
her yaks do sleep	her yaks do sleep IDENT	do
my birds dont live	my birds dont live IDENT	dont
some monkeys do giggle	some monkeys do giggle IDENT	do
her seals do live	her seals do live IDENT	do
your unicorn doesnt read	your unicorn doesnt read IDENT	doesnt
my rabbit doesnt smile	my rabbit doesnt smile IDENT	doesnt
your monkey does giggle	your monkey does giggle IDENT	does
your bird doesnt laugh	your bird doesnt laugh IDENT	doesnt
my cats do laugh	my cats do laugh IDENT	do
my unicorns dont laugh	my unicorns dont laugh IDENT	dont
your yak does smile	your yak does smile IDENT	does
our unicorns dont smile	our unicorns dont smile IDENT	dont
some unicorns do smile	some unicorns do smile IDENT	do
some unicorn does live	some unicorn does live IDENT	does
your elephant does giggle	your elephant does giggle IDENT	does
my yaks do sleep	my yaks do sleep IDENT	do
her unicorns do sleep	her unicorns do sleep IDENT	do
our elephant doesnt sleep	our elephant doesnt sleep IDENT	doesnt
the elephant does sleep	the elephant does sleep IDENT	does
our birds dont laugh	our birds dont laugh IDENT	dont
her elephant does read	her elephant does read IDENT	does
our seals do read	our seals do read IDENT	do
my rabbit doesnt sleep	my rabbit doesnt sleep IDENT	doesnt
some elephant doesnt laugh	some elephant doesnt laugh IDENT	doesnt
your rabbits dont laugh	your rabbits dont laugh IDENT	dont
the bird does live	the bird does live IDENT	does
my dogs dont sleep	my dogs dont sleep IDENT	dont
the elephant does smile	the elephant does smile IDENT	does
your birds do smile	your birds do smile IDENT	do
some cat doesnt laugh	some cat doesnt laugh IDENT	doesnt
her monkeys do laugh	her monkeys do laugh IDENT	do
our bird doesnt live	our bird doesnt live IDENT	doesnt
my cat doesnt smile	my cat doesnt smile IDENT	doesnt
her dogs dont smile	her dogs dont smile IDENT	dont
our seal does read	our seal does read IDENT	does
our monkey doesnt laugh	our monkey doesnt laugh IDENT	doesnt
some yaks do live	some yaks do live IDENT	do
the cat doesnt laugh	the cat doesnt laugh IDENT	doesnt
your dogs dont laugh	your dogs dont laugh IDENT	dont
some dogs dont read	some dogs dont read IDENT	dont
some elephants dont laugh	some elephants dont laugh IDENT	dont
the monkey doesnt giggle	the monkey doesnt giggle IDENT	doesnt
your unicorn does smile	your unicorn does smile IDENT	does
your unicorn doesnt read	your unicorn doesnt read IDENT	doesnt
our dogs do live	our dogs do live IDENT	do
some rabbit does laugh	some rabbit does laugh IDENT	does
your elephant does giggle	your elephant does giggle IDENT	does
some cats dont giggle	some cats dont giggle IDENT	dont
the unicorn doesnt smile	the unicorn doesnt smile IDENT	doesnt
your seals dont laugh	your seals dont laugh IDENT	dont
our rabbits dont live	our rabbits dont live IDENT	dont
our elephant doesnt laugh	our elephant doesnt laugh IDENT	doesnt
my dog does read	my dog does read IDENT	does
her elephants dont smile	her elephants dont smile IDENT	dont
your monkeys do sleep	your monkeys do sleep IDENT	do
my dog doesnt laugh	my dog doesnt laugh IDENT	doesnt
my seals do laugh	my seals do laugh IDENT	do
some yak does giggle	some yak does giggle IDENT	does
her unicorns do laugh	her unicorns do laugh IDENT	do
our birds do laugh	our birds do laugh IDENT	do
some seal does live	some seal does live IDENT	does
my monkey does sleep	my monkey does sleep IDENT	does
some elephant does giggle	some elephant does giggle IDENT	does
her elephants dont smile	her elephants dont smile IDENT	dont
the unicorn doesnt live	the unicorn doesnt live IDENT	doesnt
some yaks do live	some yaks do live IDENT	do
your bird doesnt laugh	your bird doesnt laugh IDENT	doesnt
her unicorns do giggle	her unicorns do giggle IDENT	do
her seals dont laugh	her seals dont laugh IDENT	dont
her rabbit doesnt smile	her rabbit doesnt smile IDENT	doesnt
our dogs dont read	our dogs dont read IDENT	dont
my yaks do read	my yaks do read IDENT	do
the seal doesnt read	the seal doesnt read IDENT	doesnt
the cats do read	the cats do read IDENT	do
some seal does laugh	some seal does laugh IDENT	does
your yak doesnt smile	your yak doesnt smile IDENT	doesnt
my rabbits dont read	my rabbits dont read IDENT	dont
her elephants do giggle	her elephants do giggle IDENT	do
the dog does laugh	the dog does laugh IDENT	does
your birds dont live	your birds dont live IDENT	dont
her monkeys dont sleep	her monkeys dont sleep IDENT	dont
our elephants dont laugh	our elephants dont laugh IDENT	dont
our cats do giggle	our cats do giggle IDENT	do
my monkey doesnt sleep	my monkey doesnt sleep IDENT	doesnt
our cats do laugh	our cats do laugh IDENT	do
her cats do laugh	her cats do laugh IDENT	do
our unicorns do laugh	our unicorns do laugh IDENT	do
our monkeys do laugh	our monkeys do laugh IDENT	do
your seal does smile	your seal does smile IDENT	does
our monkey doesnt read	our monkey doesnt read IDENT	doesnt
our unicorns dont read	our unicorns dont read IDENT	dont
her yak does laugh	her yak does laugh IDENT	does
the rabbits dont giggle	the rabbits dont giggle IDENT	dont
the unicorn does live	the unicorn does live IDENT	does
some unicorns dont read	some unicorns dont read IDENT	dont
some cat does sleep	some cat does sleep IDENT	does
your dog does read	your dog does read IDENT	does
your birds do read	your birds do read IDENT	do
the dog doesnt sleep	the dog doesnt sleep IDENT	doesnt
our elephant doesnt smile	our elephant doesnt smile IDENT	doesnt
our dog doesnt smile	our dog doesnt smile IDENT	doesnt
her seals do read	her seals do read IDENT	do
her yaks do live	her yaks do live IDENT	do
our dogs dont sleep	our dogs dont sleep IDENT	dont
my cat does read	my cat does read IDENT	does
your yak doesnt giggle	your yak doesnt giggle IDENT	doesnt
her rabbit doesnt read	her rabbit doesnt read IDENT	doesnt
the dog doesnt live	the dog doesnt live IDENT	doesnt
the rabbits do live	the rabbits do live IDENT	do
my dog does read	my dog does read IDENT	does
our rabbits do read	our rabbits do read IDENT	do
her seals dont giggle	her seals dont giggle IDENT	dont
your seals dont read	your seals dont read IDENT	dont
some rabbit doesnt giggle	some rabbit doesnt giggle IDENT	doesnt
some rabbits do giggle	some rabbits do giggle IDENT	do
my elephant doesnt laugh	my elephant doesnt laugh IDENT	doesnt
the elephants do giggle	the elephants do giggle IDENT	do
some monkeys do smile	some monkeys do smile IDENT	do
my bird does read	my bird does read IDENT	does
my elephant does live	my elephant does live IDENT	does
her dog doesnt read	her dog doesnt read IDENT	doesnt
my cat does read	my cat does read IDENT	does
the cat does read	the cat does read IDENT	does
her bird doesnt sleep	her bird doesnt sleep IDENT	doesnt
her elephant does live	her elephant does live IDENT	does
our unicorn does live	our unicorn does live IDENT	does
your birds do read	your birds do read IDENT	do
the dog does live	the dog does live IDENT	does
the yaks dont laugh	the yaks dont laugh IDENT	dont
our elephants do giggle	our elephants do giggle IDENT	do
my rabbit does live	my rabbit does live IDENT	does
the elephants dont sleep	the elephants dont sleep IDENT	dont
our yak doesnt sleep	our yak doesnt sleep IDENT	doesnt
my cat doesnt live	my cat doesnt live IDENT	doesnt
our seals do sleep	our seals do sleep IDENT	do
your cat doesnt giggle	your cat doesnt giggle IDENT	doesnt
some unicorns do live	some unicorns do live IDENT	do
your monkeys dont smile	your monkeys dont smile IDENT	dont
her bird doesnt laugh	her bird doesnt laugh IDENT	doesnt
my elephant doesnt laugh	my elephant doesnt laugh IDENT	doesnt
some monkeys do laugh	some monkeys do laugh IDENT	do
your seal doesnt live	your seal doesnt live IDENT	doesnt
her yak does giggle	her yak does giggle IDENT	does
the cats dont smile	the cats dont smile IDENT	dont
some unicorn doesnt laugh	some unicorn doesnt laugh IDENT	doesnt
my dogs do sleep	my dogs do sleep IDENT	do
your rabbits dont giggle	your rabbits dont giggle IDENT	dont
her cats do laugh	her cats do laugh IDENT	do
her bird doesnt read	her bird doesnt read IDENT	doesnt
our seals dont sleep	our seals dont sleep IDENT	dont
her monkey does sleep	her monkey does sleep IDENT	does
our seal does laugh	our seal does laugh IDENT	does
her monkeys do laugh	her monkeys do laugh IDENT	do
my cat doesnt live	my cat doesnt live IDENT	doesnt
some unicorn does smile	some unicorn does smile IDENT	does
my monkeys do smile	my monkeys do smile IDENT	do
some cat does sleep	some cat does sleep IDENT	does
some dog does sleep	some dog does sleep IDENT	does
some dogs do giggle	some dogs do giggle IDENT	do
some seal doesnt smile	some seal doesnt smile IDENT	doesnt
your dog doesnt live	your dog doesnt live IDENT	doesnt
our monkeys do giggle	our monkeys do giggle IDENT	do
your unicorns dont read	your unicorns dont read IDENT	dont
some rabbits dont live	some rabbits dont live IDENT	dont
some cats dont laugh	some cats dont laugh IDENT	dont
some elephant doesnt giggle	some elephant doesnt giggle IDENT	doesnt
our yak doesnt laugh	our yak doesnt laugh IDENT	doesnt
your rabbit does laugh	your rabbit does laugh IDENT	does
some rabbits dont read	some rabbits dont read IDENT	dont
her seal does read	her seal does read IDENT	does
her elephant does smile	her elephant does smile IDENT	does
our birds do read	our birds do read IDENT	do
her birds dont read	her birds dont read IDENT	dont
our rabbits dont smile	our rabbits dont smile IDENT	dont
your dogs do laugh	your dogs do laugh IDENT	do
your cat doesnt read	your cat doesnt read IDENT	doesnt
your cats dont laugh	your cats dont laugh IDENT	dont
your birds do laugh	your birds do laugh IDENT	do
her birds dont giggle	her birds dont giggle IDENT	dont
her elephant doesnt sleep	her elephant doesnt sleep IDENT	doesnt
the rabbit does laugh	the rabbit does laugh IDENT	does
our yaks dont giggle	our yaks dont giggle IDENT	dont
her elephants do giggle	her elephants do giggle IDENT	do
our cats dont sleep	our cats dont sleep IDENT	dont
our rabbit doesnt giggle	our rabbit doesnt giggle IDENT	doesnt
my monkey doesnt laugh	my monkey doesnt laugh IDENT	doesnt
your birds dont laugh	your birds dont laugh IDENT	dont
your monkey doesnt live	your monkey doesnt live IDENT	doesnt
our dogs do live	our dogs do live IDENT	do
her unicorn doesnt read	her unicorn doesnt read IDENT	doesnt
the unicorn does live	the unicorn does live IDENT	does
my unicorns do smile	my unicorns do smile IDENT	do
her monkeys do sleep	her monkeys do sleep IDENT	do
some bird does sleep	some bird does sleep IDENT	does
your elephant does read	your elephant does read IDENT	does
my seal does live	my seal does live IDENT	does
her unicorn doesnt laugh	her unicorn doesnt laugh IDENT	doesnt
my unicorn does read	my unicorn does read IDENT	does
my unicorn doesnt read	my unicorn doesnt read IDENT	doesnt
your rabbits dont read	your rabbits dont read IDENT	dont
your yak doesnt giggle	your yak doesnt giggle IDENT	doesnt
your seal doesnt sleep	your seal doesnt sleep IDENT	doesnt
our monkeys do laugh	our monkeys do laugh IDENT	do
our elephants dont laugh	our elephants dont laugh IDENT	dont
some elephants do sleep	some elephants do sleep IDENT	do
some seals do smile	some seals do smile IDENT	do
the unicorns do smile	the unicorns do smile IDENT	do
your dogs dont giggle	your dogs dont giggle IDENT	dont
the yaks do read	the yaks do read IDENT	do
your elephant does sleep	your elephant does sleep IDENT	does
the unicorn doesnt smile	the unicorn doesnt smile IDENT	doesnt
the yaks dont smile	the yaks dont smile IDENT	dont
my unicorn doesnt smile	my unicorn doesnt smile IDENT	doesnt
my bird does laugh	my bird does laugh IDENT	does
the elephant does laugh	the elephant does laugh IDENT	does
the cats do laugh	the cats do laugh IDENT	do
some elephant doesnt read	some elephant doesnt read IDENT	doesnt
the cat doesnt read	the cat doesnt read IDENT	doesnt
my birds dont sleep	my birds dont sleep IDENT	dont
your dogs dont laugh	your dogs dont laugh IDENT	dont
your yak does smile	your yak does smile IDENT	does
the seal does smile	the seal does smile IDENT	does
her bird doesnt smile	her bird doesnt smile IDENT	doesnt
my cat does live	my cat does live IDENT	does
some bird does smile	some bird does smile IDENT	does
some birds do smile	some birds do smile IDENT	do
your dogs do laugh	your dogs do laugh IDENT	do
my rabbits dont live	my rabbits dont live IDENT	dont
your seal doesnt live	your seal doesnt live IDENT	doesnt
some unicorns dont laugh	some unicorns dont laugh IDENT	dont
some yak doesnt laugh	some yak doesnt laugh IDENT	doesnt
some yaks do laugh	some yaks do laugh IDENT	do
her yak does read	her yak does read IDENT	does
your unicorns do giggle	your unicorns do giggle IDENT	do
her dog doesnt sleep	her dog doesnt sleep IDENT	doesnt
her rabbit does laugh	her rabbit does laugh IDENT	does
some seals do read	some seals do read IDENT	do
the cats do read	the cats do read IDENT	do
your birds do giggle	your birds do giggle IDENT	do
her birds dont read	her birds dont read IDENT	dont
the seal doesnt smile	the seal doesnt smile IDENT	doesnt
the monkeys dont smile	the monkeys dont smile IDENT	dont
your rabbits dont smile	your rabbits dont smile IDENT	dont
our unicorn doesnt laugh	our unicorn doesnt laugh IDENT	doesnt
some elephant does sleep	some elephant does sleep IDENT	does
my elephants dont smile	my elephants dont smile IDENT	dont
her birds dont laugh	her birds dont laugh IDENT	dont
some seal doesnt smile	some seal doesnt smile IDENT	doesnt
my elephants dont read	my elephants dont read IDENT	dont
my yak does read	my yak does read IDENT	does
the seal does smile	the seal does smile IDENT	does
your rabbits do smile	your rabbits do smile IDENT	do
your rabbits dont read	your rabbits dont read IDENT	dont
my rabbit doesnt smile	my rabbit doesnt smile IDENT	doesnt
some bird doesnt live	some bird doesnt live IDENT	doesnt
your cat does smile	your cat does smile IDENT	does
the dog doesnt giggle	the dog doesnt giggle IDENT	doesnt
the bird does giggle	the bird does giggle IDENT	does
the elephant does read	the elephant does read IDENT	does
our dog does giggle	our dog does giggle IDENT	does
the unicorns do giggle	the unicorns do giggle IDENT	do
our rabbit doesnt live	our rabbit doesnt live IDENT	doesnt
our rabbits dont live	our rabbits dont live IDENT	dont
our birds dont sleep	our birds dont sleep IDENT	dont
her seal does laugh	her seal does laugh IDENT	does
my birds dont laugh	my birds dont laugh IDENT	dont
her rabbits dont read	her rabbits dont read IDENT	dont
her yaks dont read	her yaks dont read IDENT	dont
your elephant does sleep	your elephant does sleep IDENT	does
your elephant doesnt sleep	your elephant doesnt sleep IDENT	doesnt
your seal doesnt read	your seal doesnt read IDENT	doesnt
the birds dont live	the birds dont live IDENT	dont
some monkeys dont smile	some monkeys dont smile IDENT	dont
her unicorn does smile	her unicorn does smile IDENT	does
your monkey doesnt read	your monkey doesnt read IDENT	doesnt
some yak does live	some yak does live IDENT	does
our rabbits do smile	our rabbits do smile IDENT	do
our yaks do laugh	our yaks do laugh IDENT	do
my bird doesnt sleep	my bird doesnt sleep IDENT	doesnt
your elephants dont giggle	your elephants dont giggle IDENT	dont
our rabbit does giggle	our rabbit does giggle IDENT	does
our monkeys do laugh	our monkeys do laugh IDENT	do
our cats do sleep	our cats do sleep IDENT	do
my cats dont sleep	my cats dont sleep IDENT	dont
her bird doesnt smile	her bird doesnt smile IDENT	doesnt
my yaks do sleep	my yaks do sleep IDENT	do
your rabbit doesnt sleep	your rabbit doesnt sleep IDENT	doesnt
her seals dont giggle	her seals dont giggle IDENT	dont
your elephants dont live	your elephants dont live IDENT	dont
our birds dont smile	our birds dont smile IDENT	dont
the unicorns dont giggle	the unicorns dont giggle IDENT	dont
our bird does laugh	our bird does laugh IDENT	does
our seals dont laugh	our seals dont laugh IDENT	dont
your dog doesnt read	your dog doesnt read IDENT	doesnt
our seal does giggle	our seal does giggle IDENT	does
her seal doesnt giggle	her seal doesnt giggle IDENT	doesnt
our cats dont giggle	our cats dont giggle IDENT	dont
our bird does read	our bird does read IDENT	does
her bird doesnt giggle	her bird doesnt giggle IDENT	doesnt
your yak does giggle	your yak does giggle IDENT	does
her cat does laugh	her cat does laugh IDENT	does
our rabbit doesnt live	our rabbit doesnt live IDENT	doesnt
my elephants do live	my elephants do live IDENT	do
her seal does laugh	her seal does laugh IDENT	does
some seal does giggle	some seal does giggle IDENT	does
our yak doesnt sleep	our yak doesnt sleep IDENT	doesnt
our cat doesnt smile	our cat doesnt smile IDENT	doesnt
her dog doesnt giggle	her dog doesnt giggle IDENT	doesnt
the rabbit doesnt live	the rabbit doesnt live IDENT	doesnt
our dogs dont laugh	our dogs dont laugh IDENT	dont
some yak doesnt live	some yak doesnt live IDENT	doesnt
her seal does live	her seal does live IDENT	does
my dog doesnt giggle	my dog doesnt giggle IDENT	doesnt
our dogs do smile	our dogs do smile IDENT	do
my birds dont smile	my birds dont smile IDENT	dont
her yak does smile	her yak does smile IDENT	does
your seal does read	your seal does read IDENT	does
some rabbit does sleep	some rabbit does sleep IDENT	does
some dogs dont sleep	some dogs dont sleep IDENT	dont
some seal doesnt sleep	some seal doesnt sleep IDENT	doesnt
the rabbits dont laugh	the rabbits dont laugh IDENT	dont
some seals dont giggle	some seals dont giggle IDENT	dont
her monkeys dont laugh	her monkeys dont laugh IDENT	dont
some yak doesnt giggle	some yak doesnt giggle IDENT	doesnt
my monkey doesnt sleep	my monkey doesnt sleep IDENT	doesnt
the dogs do smile	the dogs do smile IDENT	do
your unicorn does live	your unicorn does live IDENT	does
your unicorn does laugh	your unicorn does laugh IDENT	does
the elephant does sleep	the elephant does sleep IDENT	does
your yak doesnt read	your yak doesnt read IDENT	doesnt
the seal doesnt sleep	the seal doesnt sleep IDENT	doesnt
her dog does giggle	her dog does giggle IDENT	does
her unicorn does live	her unicorn does live IDENT	does
our elephant doesnt live	our elephant doesnt live IDENT	doesnt
her unicorn does smile	her unicorn does smile IDENT	does
some bird does laugh	some bird does laugh IDENT	does
my yaks dont sleep	my yaks dont sleep IDENT	dont
the rabbits do laugh	the rabbits do laugh IDENT	do
our yak does laugh	our yak does laugh IDENT	does
my rabbits do live	my rabbits do live IDENT	do
the seals dont live	the seals dont live IDENT	dont
our yak doesnt smile	our yak doesnt smile IDENT	doesnt
her seal does sleep	her seal does sleep IDENT	does
some unicorn doesnt giggle	some unicorn doesnt giggle IDENT	doesnt
some monkey does giggle	some monkey does giggle IDENT	does
our unicorn doesnt laugh	our unicorn doesnt laugh IDENT	doesnt
our rabbit doesnt live	our rabbit doesnt live IDENT	doesnt
our unicorn does smile	our unicorn does smile IDENT	does
her dogs do live	her dogs do live IDENT	do
some unicorn does laugh	some unicorn does laugh IDENT	does
our yak doesnt smile	our yak doesnt smile IDENT	doesnt
our dogs dont read	our dogs dont read IDENT	dont
the elephant doesnt live	the elephant doesnt live IDENT	doesnt
your elephants do laugh	your elephants do laugh IDENT	do
our elephants do laugh	our elephants do laugh IDENT	do
her dog does read	her dog does read IDENT	does
my monkeys do read	my monkeys do read IDENT	do
your unicorns dont giggle	your unicorns dont giggle IDENT	dont
the dog doesnt giggle	the dog doesnt giggle IDENT	doesnt
the rabbits dont giggle	the rabbits dont giggle IDENT	dont
some birds dont sleep	some birds dont sleep IDENT	dont
our monkey does read	our monkey does read IDENT	does
our bird doesnt giggle	our bird doesnt giggle IDENT	doesnt
my elephant doesnt giggle	my elephant doesnt giggle IDENT	doesnt
my bird doesnt laugh	my bird doesnt laugh IDENT	doesnt
your monkey does laugh	your monkey does laugh IDENT	does
your rabbit does sleep	your rabbit does sleep IDENT	does
the yaks do giggle	the yaks do giggle IDENT	do
my dog doesnt laugh	my dog doesnt laugh IDENT	doesnt
some yaks dont live	some yaks dont live IDENT	dont
our yaks do sleep	our yaks do sleep IDENT	do
the bird does live	the bird does live IDENT	does
the yaks dont live	the yaks dont live IDENT	dont
the cat doesnt live	the cat doesnt live IDENT	doesnt
the birds dont read	the birds dont read IDENT	dont
our seals dont laugh	our seals dont laugh IDENT	dont
our cat doesnt sleep	our cat doesnt sleep IDENT	doesnt
my elephant doesnt giggle	my elephant doesnt giggle IDENT	doesnt
my unicorns dont read	my unicorns dont read IDENT	dont
my yak doesnt laugh	my yak doesnt laugh IDENT	doesnt
her birds do laugh	her birds do laugh IDENT	do
my elephants do live	my elephants do live IDENT	do
the monkey doesnt giggle	the monkey doesnt giggle IDENT	doesnt
her cat does laugh	her cat does laugh IDENT	does
her elephant does sleep	her elephant does sleep IDENT	does
her dog doesnt laugh	her dog doesnt laugh IDENT	doesnt
our cat does laugh	our cat does laugh IDENT	does
our birds dont read	our birds dont read IDENT	dont
her cats dont live	her cats dont live IDENT	dont
our monkeys do laugh	our monkeys do laugh IDENT	do
her unicorns dont giggle	her unicorns dont giggle IDENT	dont
our unicorns dont giggle	our unicorns dont giggle IDENT	dont
your monkeys do smile	your monkeys do smile IDENT	do
her seal doesnt live	her seal doesnt live IDENT	doesnt
her elephants do live	her elephants do live IDENT	do
our seals do live	our seals do live IDENT	do
some rabbits do smile	some rabbits do smile IDENT	do
some elephants do laugh	some elephants do laugh IDENT	do
her bird does read	her bird does read IDENT	does
my dogs dont giggle	my dogs dont giggle IDENT	dont
the dogs dont smile	the dogs dont smile IDENT	dont
your dog doesnt giggle	your dog doesnt giggle IDENT	doesnt
my birds dont live	my birds dont live IDENT	dont
my unicorn doesnt smile	my unicorn doesnt smile IDENT	doesnt
her dog doesnt giggle	her dog doesnt giggle IDENT	doesnt
the elephants dont read	the elephants dont read IDENT	dont
her rabbit doesnt live	her rabbit doesnt live IDENT	doesnt
her monkey doesnt read	her monkey doesnt read IDENT	doesnt
the monkeys do read	the monkeys do read IDENT	do
the monkey does giggle	the monkey does giggle IDENT	does
my bird doesnt giggle	my bird doesnt giggle IDENT	doesnt
some elephant doesnt laugh	some elephant doesnt laugh IDENT	doesnt
your unicorn does read	your unicorn does read IDENT	does
your rabbit doesnt smile	your rabbit doesnt smile IDENT	doesnt
her monkey does live	her monkey does live IDENT	does
my cats do sleep	my cats do sleep IDENT	do
some birds do read	some birds do read IDENT	do
her cat doesnt smile	her cat doesnt smile IDENT	doesnt
her yaks do giggle	her yaks do giggle IDENT	do
some yaks do giggle	some yaks do giggle IDENT	do
her rabbit does laugh	her rabbit does laugh IDENT	does
your elephants do laugh	your elephants do laugh IDENT	do
some monkey doesnt live	some monkey doesnt live IDENT	doesnt
the cat doesnt live	the cat doesnt live IDENT	doesnt
our unicorns do giggle	our unicorns do giggle IDENT	do
our cat doesnt smile	our cat doesnt smile IDENT	doesnt
our yak doesnt smile	our yak doesnt smile IDENT	doesnt
my dog does read	my dog does read IDENT	does
the dog does read	the dog does read IDENT	does
her monkeys dont sleep	her monkeys dont sleep IDENT	dont
the rabbits dont read	the rabbits dont read IDENT	dont
her cats do giggle	her cats do giggle IDENT	do
some elephant doesnt live	some elephant doesnt live IDENT	doesnt
her unicorn doesnt sleep	her unicorn doesnt sleep IDENT	doesnt
her dogs dont laugh	her dogs dont laugh IDENT	dont
the yaks do read	the yaks do read IDENT	do
my unicorn doesnt smile	my unicorn doesnt smile IDENT	doesnt
our cats dont live	our cats dont live IDENT	dont
my elephants dont live	my elephants dont live IDENT	dont
her yak doesnt sleep	her yak doesnt sleep IDENT	doesnt
some unicorns dont read	some unicorns dont read IDENT	dont
her cat doesnt giggle	her cat doesnt giggle IDENT	doesnt
our monkeys dont laugh	our monkeys dont laugh IDENT	dont
our monkeys dont live	our monkeys dont live IDENT	dont
her monkeys dont giggle	her monkeys dont giggle IDENT	dont
the rabbits dont read	the rabbits dont read IDENT	dont
her unicorn does read	her unicorn does read IDENT	does
some yak doesnt read	some yak doesnt read IDENT	doesnt
your unicorns dont giggle	your unicorns dont giggle IDENT	dont
our elephant does laugh	our elephant does laugh IDENT	does
our unicorn does live	our unicorn does live IDENT	does
our yak does giggle	our yak does giggle IDENT	does
our seals dont smile	our seals dont smile IDENT	dont
her rabbits dont laugh	her rabbits dont laugh IDENT	dont
our seal does smile	our seal does smile IDENT	does
some cat does laugh	some cat does laugh IDENT	does
the rabbit does live	the rabbit does live IDENT	does
some yaks dont laugh	some yaks dont laugh IDENT	dont
our elephant doesnt giggle	our elephant doesnt giggle IDENT	doesnt
the birds do sleep	the birds do sleep IDENT	do
the birds dont giggle	the birds dont giggle IDENT	dont
our yaks do giggle	our yaks do giggle IDENT	do
the unicorn doesnt laugh	the unicorn doesnt laugh IDENT	doesnt
some monkey doesnt live	some monkey doesnt live IDENT	doesnt
my monkeys dont smile	my monkeys dont smile IDENT	dont
some unicorn does smile	some unicorn does smile IDENT	does
the rabbit does live	the rabbit does live IDENT	does
your unicorn doesnt laugh	your unicorn doesnt laugh IDENT	doesnt
our cats do read	our cats do read IDENT	do
her elephant does read	her elephant does read IDENT	does
some dog does read	some dog does read IDENT	does
her cat doesnt live	her cat doesnt live IDENT	doesnt
some unicorn doesnt read	some unicorn doesnt read IDENT	doesnt
some rabbits do live	some rabbits do live IDENT	do
my yaks do laugh	my yaks do laugh IDENT	do
her cats dont sleep	her cats dont sleep IDENT	dont
your monkeys dont smile	your monkeys dont smile IDENT	dont
your unicorns do sleep	your unicorns do sleep IDENT	do
our seal does laugh	our seal does laugh IDENT	does
our dog does live	our dog does live IDENT	does
some monkeys do live	some monkeys do live IDENT	do
your rabbit does live	your rabbit does live IDENT	does
some unicorn doesnt giggle	some unicorn doesnt giggle IDENT	doesnt
the yaks do giggle	the yaks do giggle IDENT	do
some cat doesnt live	some cat doesnt live IDENT	doesnt
my elephant doesnt smile	my elephant doesnt smile IDENT	doesnt
my monkey does live	my monkey does live IDENT	does
my dog does live	my dog does live IDENT	does
our cats dont smile	our cats dont smile IDENT	dont
our dogs do read	our dogs do read IDENT	do
my dog doesnt read	my dog doesnt read IDENT	doesnt
your cat doesnt read	your cat doesnt read IDENT	doesnt
my monkeys dont smile	my monkeys dont smile IDENT	dont
your rabbits do smile	your rabbits do smile IDENT	do
our dogs dont smile	our dogs dont smile IDENT	dont
the yak doesnt giggle	the yak doesnt giggle IDENT	doesnt
the elephants do laugh	the elephants do laugh IDENT	do
our elephants do smile	our elephants do smile IDENT	do
my yak doesnt giggle	my yak doesnt giggle IDENT	doesnt
her cat does smile	her cat does smile IDENT	does
the cats do live	the cats do live IDENT	do
some cats do laugh	some cats do laugh IDENT	do
my yaks dont read	my yaks dont read IDENT	dont
her rabbit doesnt laugh	her rabbit doesnt laugh IDENT	doesnt
your cats do giggle	your cats do giggle IDENT	do
some bird doesnt giggle	some bird doesnt giggle IDENT	doesnt
my monkeys dont live	my monkeys dont live IDENT	dont
our monkeys dont smile	our monkeys dont smile IDENT	dont
my seals dont read	my seals dont read IDENT	dont
our dogs do smile	our dogs do smile IDENT	do
my seal does live	my seal does live IDENT	does
our unicorns do giggle	our unicorns do giggle IDENT	do
some cats do laugh	some cats do laugh IDENT	do
my seals do sleep	my seals do sleep IDENT	do
the seal doesnt laugh	the seal doesnt laugh IDENT	doesnt
her elephants do smile	her elephants do smile IDENT	do
our seal does giggle	our seal does giggle IDENT	does
her cat doesnt laugh	her cat doesnt laugh IDENT	doesnt
our yaks dont read	our yaks dont read IDENT	dont
my dogs do live	my dogs do live IDENT	do
my seal does smile	my seal does smile IDENT	does
my monkeys do smile	my monkeys do smile IDENT	do
my seals dont smile	my seals dont smile IDENT	dont
her seal doesnt giggle	her seal doesnt giggle IDENT	doesnt
my unicorns do smile	my unicorns do smile IDENT	do
your cats do giggle	your cats do giggle IDENT	do
her monkey doesnt giggle	her monkey doesnt giggle IDENT	doesnt
my monkey does giggle	my monkey does giggle IDENT	does
my seals do laugh	my seals do laugh IDENT	do
my unicorn does giggle	my unicorn does giggle IDENT	does
the seals do sleep	the seals do sleep IDENT	do
our elephants dont sleep	our elephants dont sleep IDENT	dont
our dogs do laugh	our dogs do laugh IDENT	do
our elephant doesnt live	our elephant doesnt live IDENT	doesnt
your unicorn does read	your unicorn does read IDENT	does
some yaks do read	some yaks do read IDENT	do
her dog does laugh	her dog does laugh IDENT	does
my birds dont live	my birds dont live IDENT	dont
her birds do live	her birds do live IDENT	do
some rabbits dont laugh	some rabbits dont laugh IDENT	dont
our rabbits do read	our rabbits do read IDENT	do
her yak doesnt read	her yak doesnt read IDENT	doesnt
some rabbit doesnt live	some rabbit doesnt live IDENT	doesnt
my elephant does read	my elephant does read IDENT	does
our cat does sleep	our cat does sleep IDENT	does
my monkey doesnt live	my monkey doesnt live IDENT	doesnt
our seals dont sleep	our seals dont sleep IDENT	dont
my monkey doesnt read	my monkey doesnt read IDENT	doesnt
the bird doesnt giggle	the bird doesnt giggle IDENT	doesnt
the cat does giggle	the cat does giggle IDENT	does
my dog doesnt read	my dog doesnt read IDENT	doesnt
our bird doesnt laugh	our bird doesnt laugh IDENT	doesnt
our cat does smile	our cat does smile IDENT	does
some bird does smile	some bird does smile IDENT	does
some bird doesnt read	some bird doesnt read IDENT	doesnt
the dogs do giggle	the dogs do giggle IDENT	do
the bird does smile	the bird does smile IDENT	does
your seals do sleep	your seals do sleep IDENT	do
some rabbit doesnt sleep	some rabbit doesnt sleep IDENT	doesnt
my unicorn does sleep	my unicorn does sleep IDENT	does
her monkey does live	her monkey does live IDENT	does
the birds do sleep	the birds do sleep IDENT	do
your yaks dont live	your yaks dont live IDENT	dont
your yak does sleep	your yak does sleep IDENT	does
the elephant doesnt live	the elephant doesnt live IDENT	doesnt
some dog doesnt giggle	some dog doesnt giggle IDENT	doesnt
some dogs dont live	some dogs dont live IDENT	dont
her dogs do live	her dogs do live IDENT	do
some cat does live	some cat does live IDENT	does
your yak doesnt giggle	your yak doesnt giggle IDENT	doesnt
the seals dont smile	the seals dont smile IDENT	dont
my rabbits dont live	my rabbits dont live IDENT	dont
the bird does smile	the bird does smile IDENT	does
some unicorns do sleep	some unicorns do sleep IDENT	do
the cats do laugh	the cats do laugh IDENT	do
your dogs dont laugh	your dogs dont laugh IDENT	dont
my monkeys do live	my monkeys do live IDENT	do
my cats do read	my cats do read IDENT	do
her seals dont sleep	her seals dont sleep IDENT	dont
your rabbit does sleep	your rabbit does sleep IDENT	does
the unicorn doesnt laugh	the unicorn doesnt laugh IDENT	doesnt
your yaks do read	your yaks do read IDENT	do
your unicorn does sleep	your unicorn does sleep IDENT	does
your seals dont sleep	your seals dont sleep IDENT	dont
our unicorns dont smile	our unicorns dont smile IDENT	dont
her cats do read	her cats do read IDENT	do
my seals do sleep	my seals do sleep IDENT	do
my seals do smile	my seals do smile IDENT	do
my elephants dont sleep	my elephants dont sleep IDENT	dont
her seals do sleep	her seals do sleep IDENT	do
some seal does smile	some seal does smile IDENT	does
my monkey does live	my monkey does live IDENT	does
her cat doesnt live	her cat doesnt live IDENT	doesnt
your elephants do sleep	your elephants do sleep IDENT	do
our rabbits do live	our rabbits do live IDENT	do
the monkey does sleep	the monkey does sleep IDENT	does
our unicorn does live	our unicorn does live IDENT	does
our elephant does laugh	our elephant does laugh IDENT	does
your birds dont smile	your birds dont smile IDENT	dont
some dog does read	some dog does read IDENT	does
the dog does read	the dog does read IDENT	does
her monkey doesnt live	her monkey doesnt live IDENT	doesnt
your rabbits do smile	your rabbits do smile IDENT	do
our birds dont smile	our birds dont smile IDENT	dont
my dog doesnt laugh	my dog doesnt laugh IDENT	doesnt
our monkeys dont smile	our monkeys dont smile IDENT	dont
your unicorn does sleep	your unicorn does sleep IDENT	does
her bird doesnt smile	her bird doesnt smile IDENT	doesnt
your unicorns do read	your unicorns do read IDENT	do
her rabbit does laugh	her rabbit does laugh IDENT	does
her rabbit doesnt laugh	her rabbit doesnt laugh IDENT	doesnt
your yaks dont smile	your yaks dont smile IDENT	dont
my seals dont live	my seals dont live IDENT	dont
my yaks dont live	my yaks dont live IDENT	dont
my cats do giggle	my cats do giggle IDENT	do
your unicorn does live	your unicorn does live IDENT	does
her elephant doesnt laugh	her elephant doesnt laugh IDENT	doesnt
her elephant does smile	her elephant does smile IDENT	does
my cats dont smile	my cats dont smile IDENT	dont
some unicorn doesnt smile	some unicorn doesnt smile IDENT	doesnt
our yaks do smile	our yaks do smile IDENT	do
some dog doesnt sleep	some dog doesnt sleep IDENT	doesnt
some rabbit does laugh	some rabbit does laugh IDENT	does
my cat does live	my cat does live IDENT	does
my yaks do live	my yaks do live IDENT	do
my yaks do read	my yaks do read IDENT	do
her monkey doesnt laugh	her monkey doesnt laugh IDENT	doesnt
our yak does smile	our yak does smile IDENT	does
our unicorns dont laugh	our unicorns dont laugh IDENT	dont
our rabbits do sleep	our rabbits do sleep IDENT	do
my monkeys do read	my monkeys do read IDENT	do
your bird does laugh	your bird does laugh IDENT	does
some yak does laugh	some yak does laugh IDENT	does
the yaks dont sleep	the yaks dont sleep IDENT	dont
her bird does read	her bird does read IDENT	does
her cat doesnt laugh	her cat doesnt laugh IDENT	doesnt
your dogs do smile	your dogs do smile IDENT	do
our cats do giggle	our cats do giggle IDENT	do
the monkey does laugh	the monkey does laugh IDENT	does
the rabbits do read	the rabbits do read IDENT	do
some unicorns do laugh	some unicorns do laugh IDENT	do
my unicorns dont read	my unicorns dont read IDENT	dont
the monkeys dont smile	the monkeys dont smile IDENT	dont
some seals dont sleep	some seals dont sleep IDENT	dont
our elephants do giggle	our elephants do giggle IDENT	do
our cat doesnt smile	our cat doesnt smile IDENT	doesnt
your cat doesnt sleep	your cat doesnt sleep IDENT	doesnt
my yaks do giggle	my yaks do giggle IDENT	do
my dogs do giggle	my dogs do giggle IDENT	do
the dogs do giggle	the dogs do giggle IDENT	do
my monkey doesnt giggle	my monkey doesnt giggle IDENT	doesnt
her yak does giggle	her yak does giggle IDENT	does
our elephant doesnt live	our elephant doesnt live IDENT	doesnt
some cat does live	some cat does live IDENT	does
our rabbits do read	our rabbits do read IDENT	do
her elephants do read	her elephants do read IDENT	do
her cat doesnt giggle	her cat doesnt giggle IDENT	doesnt
our rabbit does laugh	our rabbit does laugh IDENT	does
our seals dont laugh	our seals dont laugh IDENT	dont
your elephants do live	your elephants do live IDENT	do
some cats do live	some cats do live IDENT	do
her birds do read	her birds do read IDENT	do
our elephant doesnt live	our elephant doesnt live IDENT	doesnt
some unicorns dont sleep	some unicorns dont sleep IDENT	dont
my monkey does smile	my monkey does smile IDENT	does
my seal does read	my seal does read IDENT	does
your seal does read	your seal does read IDENT	does
some seal does giggle	some seal does giggle IDENT	does
her elephant does read	her elephant does read IDENT	does
her monkeys dont read	her monkeys dont read IDENT	dont
my elephant does sleep	my elephant does sleep IDENT	does
our dog does smile	our dog does smile IDENT	does
our seals do live	our seals do live IDENT	do
my cats do laugh	my cats do laugh IDENT	do
our dog doesnt giggle	our dog doesnt giggle IDENT	doesnt
the rabbits do laugh	the rabbits do laugh IDENT	do
our monkeys dont smile	our monkeys dont smile IDENT	dont
my rabbits do giggle	my rabbits do giggle IDENT	do
my dog doesnt laugh	my dog doesnt laugh IDENT	doesnt
my unicorns dont sleep	my unicorns dont sleep IDENT	dont
her cats do sleep	her cats do sleep IDENT	do
my birds do live	my birds do live IDENT	do
her rabbit does giggle	her rabbit does giggle IDENT	does
our unicorns do live	our unicorns do live IDENT	do
my monkeys do read	my monkeys do read IDENT	do
my seal does smile	my seal does smile IDENT	does
our cats do smile	our cats do smile IDENT	do
our monkey does giggle	our monkey does giggle IDENT	does
the seals do read	the seals do read IDENT	do
your cat does laugh	your cat does laugh IDENT	does
our yak does smile	our yak does smile IDENT	does
my seals dont giggle	my seals dont giggle IDENT	dont
our cats dont sleep	our cats dont sleep IDENT	dont
your yak doesnt sleep	your yak doesnt sleep IDENT	doesnt
my cats do read	my cats do read IDENT	do
the yaks dont smile	the yaks dont smile IDENT	dont
the dogs dont smile	the dogs dont smile IDENT	dont
some rabbits dont giggle	some rabbits dont giggle IDENT	dont
her yak doesnt live	her yak doesnt live IDENT	doesnt
her monkey does smile	her monkey does smile IDENT	does
your rabbit does smile	your rabbit does smile IDENT	does
her dog does smile	her dog does smile IDENT	does
your yak doesnt live	your yak doesnt live IDENT	doesnt
her dogs dont live	her dogs dont live IDENT	dont
her monkeys dont live	her monkeys dont live IDENT	dont
her unicorn doesnt read	her unicorn doesnt read IDENT	doesnt
my yak does sleep	my yak does sleep IDENT	does
your birds dont smile	your birds dont smile IDENT	dont
her rabbit doesnt giggle	her rabbit doesnt giggle IDENT	doesnt
our unicorns dont giggle	our unicorns dont giggle IDENT	dont
some elephants dont smile	some elephants dont smile IDENT	dont
the rabbit does live	the rabbit does live IDENT	does
our rabbits do smile	our rabbits do smile IDENT	do
your unicorn doesnt giggle	your unicorn doesnt giggle IDENT	doesnt
the monkeys dont smile	the monkeys dont smile IDENT	dont
the seal doesnt smile	the seal doesnt smile IDENT	doesnt
your monkey does smile	your monkey does smile IDENT	does
our monkeys dont smile	our monkeys dont smile IDENT	dont
her dogs dont laugh	her dogs dont laugh IDENT	dont
our seal does smile	our seal does smile IDENT	does
some dogs do live	some dogs do live IDENT	do
some elephant does live	some elephant does live IDENT	does
your elephant doesnt giggle	your elephant doesnt giggle IDENT	doesnt
our yak does sleep	our yak does sleep IDENT	does
the yak does sleep	the yak does sleep IDENT	does
the dog does sleep	the dog does sleep IDENT	does
my elephants dont sleep	my elephants dont sleep IDENT	dont
your rabbit doesnt live	your rabbit doesnt live IDENT	doesnt
your monkeys dont read	your monkeys dont read IDENT	dont
our seals do smile	our seals do smile IDENT	do
our dogs dont giggle	our dogs dont giggle IDENT	dont
some unicorns dont read	some unicorns dont read IDENT	dont
her cat doesnt sleep	her cat doesnt sleep IDENT	doesnt
your elephants dont live	your elephants dont live IDENT	dont
our monkey does laugh	our monkey does laugh IDENT	does
our cat doesnt giggle	our cat doesnt giggle IDENT	doesnt
the elephant does laugh	the elephant does laugh IDENT	does
our bird does live	our bird does live IDENT	does
our bird does giggle	our bird does giggle IDENT	does
her seal does live	her seal does live IDENT	does
the unicorns dont sleep	the unicorns dont sleep IDENT	dont
her yaks do laugh	her yaks do laugh IDENT	do
the rabbits do sleep	the rabbits do sleep IDENT	do
our yak doesnt read	our yak doesnt read IDENT	doesnt
my birds do smile	my birds do smile IDENT	do
my elephants dont live	my elephants dont live IDENT	dont
the unicorns do giggle	the unicorns do giggle IDENT	do
the monkey does giggle	the monkey does giggle IDENT	does
her seal does read	her seal does read IDENT	does
her dog doesnt read	her dog doesnt read IDENT	doesnt
your rabbit doesnt laugh	your rabbit doesnt laugh IDENT	doesnt
some rabbits dont smile	some rabbits dont smile IDENT	dont
some unicorns do live	some unicorns do live IDENT	do
my dogs dont sleep	my dogs dont sleep IDENT	dont
your seals dont live	your seals dont live IDENT	dont
her dogs dont sleep	her dogs dont sleep IDENT	dont
my birds do live	my birds do live IDENT	do
some bird does live	some bird does live IDENT	does
some cat does giggle	some cat does giggle IDENT	does
my unicorns dont giggle	my unicorns dont giggle IDENT	dont
your elephant doesnt sleep	your elephant doesnt sleep IDENT	doesnt
our rabbit does giggle	our rabbit does giggle IDENT	does
the rabbits dont sleep	the rabbits dont sleep IDENT	dont
the elephant does giggle	the elephant does giggle IDENT	does
the seals dont smile	the seals dont smile IDENT	dont
her unicorns do giggle	her unicorns do giggle IDENT	do
my cats do giggle	my cats do giggle IDENT	do
her birds dont laugh	her birds dont laugh IDENT	dont
our monkeys do sleep	our monkeys do sleep IDENT	do
the rabbit doesnt giggle	the rabbit doesnt giggle IDENT	doesnt
the dogs do giggle	the dogs do giggle IDENT	do
our unicorn doesnt laugh	our unicorn doesnt laugh IDENT	doesnt
the dog does laugh	the dog does laugh IDENT	does
the seals dont live	the seals dont live IDENT	dont
your rabbits dont giggle	your rabbits dont giggle IDENT	dont
some monkey does live	some monkey does live IDENT	does
her unicorn does giggle	her unicorn does giggle IDENT	does
her rabbits do giggle	her rabbits do giggle IDENT	do
her monkeys do giggle	her monkeys do giggle IDENT	do
some monkey does sleep	some monkey does sleep IDENT	does
your dog doesnt read	your dog doesnt read IDENT	doesnt
her cats dont live	her cats dont live IDENT	dont
her seal does sleep	her seal does sleep IDENT	does
the seal does read	the seal does read IDENT	does
the unicorns do sleep	the unicorns do sleep IDENT	do
her unicorn does sleep	her unicorn does sleep IDENT	does
some unicorns dont sleep	some unicorns dont sleep IDENT	dont
her cat does sleep	her cat does sleep IDENT	does
her elephant does live	her elephant does live IDENT	does
some monkeys dont laugh	some monkeys dont laugh IDENT	dont
some monkey does giggle	some monkey does giggle IDENT	does
our yaks do live	our yaks do live IDENT	do
our elephants dont live	our elephants dont live IDENT	dont
my monkey does live	my monkey does live IDENT	does
her dog doesnt laugh	her dog doesnt laugh IDENT	doesnt
the unicorns do giggle	the unicorns do giggle IDENT	do
her bird doesnt smile	her bird doesnt smile IDENT	doesnt
my rabbit doesnt laugh	my rabbit doesnt laugh IDENT	doesnt
your seal doesnt giggle	your seal doesnt giggle IDENT	doesnt
some yak doesnt giggle	some yak doesnt giggle IDENT	doesnt
the yaks do read	the yaks do read IDENT	do
your yaks dont giggle	your yaks dont giggle IDENT	dont
her monkeys do giggle	her monkeys do giggle IDENT	do
our dogs dont smile	our dogs dont smile IDENT	dont
some cat does sleep	some cat does sleep IDENT	does
some unicorns do giggle	some unicorns do giggle IDENT	do
some unicorn doesnt giggle	some unicorn doesnt giggle IDENT	doesnt
your monkeys do sleep	your monkeys do sleep IDENT	do
your monkey doesnt smile	your monkey doesnt smile IDENT	doesnt
the dog does smile	the dog does smile IDENT	does
the rabbits do laugh	the rabbits do laugh IDENT	do
our elephant doesnt giggle	our elephant doesnt giggle IDENT	doesnt
your rabbits do live	your rabbits do live IDENT	do
our yaks dont sleep	our yaks dont sleep IDENT	dont
some cat does live	some cat does live IDENT	does
your monkeys do live	your monkeys do live IDENT	do
my birds dont sleep	my birds dont sleep IDENT	dont
her seal does live	her seal does live IDENT	does
our rabbit does read	our rabbit does read IDENT	does
your cat doesnt read	your cat doesnt read IDENT	doesnt
my seal does giggle	my seal does giggle IDENT	does
my cats dont smile	my cats dont smile IDENT	dont
her yak does read	her yak does read IDENT	does
our seal does laugh	our seal does laugh IDENT	does
my dog does laugh	my dog does laugh IDENT	does
the dogs dont read	the dogs dont read IDENT	dont
our rabbits do live	our rabbits do live IDENT	do
the unicorns dont smile	the unicorns dont smile IDENT	dont
my dogs dont laugh	my dogs dont laugh IDENT	dont
our yaks do laugh	our yaks do laugh IDENT	do
our cats dont live	our cats dont live IDENT	dont
your rabbits dont sleep	your rabbits dont sleep IDENT	dont
my unicorn does smile	my unicorn does smile IDENT	does
the rabbits do smile	the rabbits do smile IDENT	do
my cats do sleep	my cats do sleep IDENT	do
our unicorns dont giggle	our unicorns dont giggle IDENT	dont
her elephant does smile	her elephant does smile IDENT	does
the elephant doesnt smile	the elephant doesnt smile IDENT	doesnt
your cat does giggle	your cat does giggle IDENT	does
your rabbits dont laugh	your rabbits dont laugh IDENT	dont
my monkeys dont laugh	my monkeys dont laugh IDENT	dont
our unicorn does laugh	our unicorn does laugh IDENT	does
the bird does smile	the bird does smile IDENT	does
the seals dont read	the seals dont read IDENT	dont
some rabbits do sleep	some rabbits do sleep IDENT	do
our monkey does giggle	our monkey does giggle IDENT	does
the monkey doesnt laugh	the monkey doesnt laugh IDENT	doesnt
the rabbits dont sleep	the rabbits dont sleep IDENT	dont
some cats dont smile	some cats dont smile IDENT	dont
some monkey does smile	some monkey does smile IDENT	does
your yaks do laugh	your yaks do laugh IDENT	do
our birds do read	our birds do read IDENT	do
our birds dont read	our birds dont read IDENT	dont
the cats dont read	the cats dont read IDENT	dont
some bird doesnt giggle	some bird doesnt giggle IDENT	doesnt
the seal does sleep	the seal does sleep IDENT	does
your unicorns do laugh	your unicorns do laugh IDENT	do
your elephant does sleep	your elephant does sleep IDENT	does
your elephant doesnt live	your elephant doesnt live IDENT	doesnt
your birds do smile	your birds do smile IDENT	do
my dog does laugh	my dog does laugh IDENT	does
my dogs dont read	my dogs dont read IDENT	dont
her birds do live	her birds do live IDENT	do
our cat doesnt giggle	our cat doesnt giggle IDENT	doesnt
the bird doesnt giggle	the bird doesnt giggle IDENT	doesnt
my yak does live	my yak does live IDENT	does
her monkey does laugh	her monkey does laugh IDENT	does
our rabbits dont laugh	our rabbits dont laugh IDENT	dont
your elephant does smile	your elephant does smile IDENT	does
our bird doesnt smile	our bird doesnt smile IDENT	doesnt
your seals dont live	your seals dont live IDENT	dont
the unicorn doesnt laugh	the unicorn doesnt laugh IDENT	doesnt
some rabbit doesnt read	some rabbit doesnt read IDENT	doesnt
our dog doesnt laugh	our dog doesnt laugh IDENT	doesnt
our bird doesnt live	our bird doesnt live IDENT	doesnt
some monkeys do sleep	some monkeys do sleep IDENT	do
your dogs dont sleep	your dogs dont sleep IDENT	dont
our monkey doesnt smile	our monkey doesnt smile IDENT	doesnt
our elephants dont live	our elephants dont live IDENT	dont
our elephants dont laugh	our elephants dont laugh IDENT	dont
your birds do live	your birds do live IDENT	do
my unicorn does read	my unicorn does read IDENT	does
your rabbits do read	your rabbits do read IDENT	do
my dog does laugh	my dog does laugh IDENT	does
our seal doesnt smile	our seal doesnt smile IDENT	doesnt
her seal does sleep	her seal does sleep IDENT	does
my yaks dont laugh	my yaks dont laugh IDENT	dont
our unicorn does giggle	our unicorn does giggle IDENT	does
her cats do read	her cats do read IDENT	do
some dog does laugh	some dog does laugh IDENT	does
some birds dont sleep	some birds dont sleep IDENT	dont
her yaks do sleep	her yaks do sleep IDENT	do
my unicorn doesnt sleep	my unicorn doesnt sleep IDENT	doesnt
the elephant doesnt live	the elephant doesnt live IDENT	doesnt
my yaks do giggle	my yaks do giggle IDENT	do
my seal doesnt sleep	my seal doesnt sleep IDENT	doesnt
my cats do smile	my cats do smile IDENT	do
my elephant doesnt laugh	my elephant doesnt laugh IDENT	doesnt
some dogs dont laugh	some dogs dont laugh IDENT	dont
some seals do giggle	some seals do giggle IDENT	do
the birds dont sleep	the birds dont sleep IDENT	dont
some birds dont live	some birds dont live IDENT	dont
the unicorns dont laugh	the unicorns dont laugh IDENT	dont
her seals do laugh	her seals do laugh IDENT	do
her rabbits do live	her rabbits do live IDENT	do
her rabbit does smile	her rabbit does smile IDENT	does
our seal doesnt read	our seal doesnt read IDENT	doesnt
the birds dont sleep	the birds dont sleep IDENT	dont
my rabbits do smile	my rabbits do smile IDENT	do
our dog doesnt smile	our dog doesnt smile IDENT	doesnt
our elephant does giggle	our elephant does giggle IDENT	does
your unicorn does laugh	your unicorn does laugh IDENT	does
your yaks do smile	your yaks do smile IDENT	do
some unicorn does giggle	some unicorn does giggle IDENT	does
the dogs do read	the dogs do read IDENT	do
our cat doesnt live	our cat doesnt live IDENT	doesnt
our seal does live	our seal does live IDENT	does
your elephant does giggle	your elephant does giggle IDENT	does
your rabbits dont read	your rabbits dont read IDENT	dont
some cats do sleep	some cats do sleep IDENT	do
the yaks do read	the yaks do read IDENT	do
the elephants do read	the elephants do read IDENT	do
our bird does laugh	our bird does laugh IDENT	does
our dogs dont live	our dogs dont live IDENT	dont
the seals do read	the seals do read IDENT	do
my dog doesnt giggle	my dog doesnt giggle IDENT	doesnt
my elephants dont sleep	my elephants dont sleep IDENT	dont
the cats dont sleep	the cats dont sleep IDENT	dont
my monkey doesnt smile	my monkey doesnt smile IDENT	doesnt
our birds do laugh	our birds do laugh IDENT	do
my seals do smile	my seals do smile IDENT	do
the rabbits do giggle	the rabbits do giggle IDENT	do
your birds dont smile	your birds dont smile IDENT	dont
our cat does sleep	our cat does sleep IDENT	does
my yaks dont live	my yaks dont live IDENT	dont
our cat doesnt live	our cat doesnt live IDENT	doesnt
your seals dont sleep	your seals dont sleep IDENT	dont
the yaks dont laugh	the yaks dont laugh IDENT	dont
your dogs dont read	your dogs dont read IDENT	dont
some yaks do giggle	some yaks do giggle IDENT	do
your seals dont laugh	your seals dont laugh IDENT	dont
my seals do giggle	my seals do giggle IDENT	do
the elephants dont smile	the elephants dont smile IDENT	dont
some dogs do giggle	some dogs do giggle IDENT	do
the seal does read	the seal does read IDENT	does
our dog doesnt sleep	our dog doesnt sleep IDENT	doesnt
her yak does read	her yak does read IDENT	does
our monkeys do read	our monkeys do read IDENT	do
some dog does giggle	some dog does giggle IDENT	does
some yak does giggle	some yak does giggle IDENT	does
some cat does smile	some cat does smile IDENT	does
the elephants dont live	the elephants dont live IDENT	dont
her cat doesnt giggle	her cat doesnt giggle IDENT	doesnt
the elephant doesnt giggle	the elephant doesnt giggle IDENT	doesnt
her bird doesnt smile	her bird doesnt smile IDENT	doesnt
her cats dont live	her cats dont live IDENT	dont
our bird does laugh	our bird does laugh IDENT	does
our yaks dont laugh	our yaks dont laugh IDENT	dont
our monkey does sleep	our monkey does sleep IDENT	does
our yak doesnt laugh	our yak doesnt laugh IDENT	doesnt
our yak doesnt sleep	our yak doesnt sleep IDENT	doesnt
the seals do giggle	the seals do giggle IDENT	do
some unicorn does sleep	some unicorn does sleep IDENT	does
our unicorn does sleep	our unicorn does sleep IDENT	does
the rabbits dont laugh	the rabbits dont laugh IDENT	dont
your cat doesnt smile	your cat doesnt smile IDENT	doesnt
your unicorn doesnt smile	your unicorn doesnt smile IDENT	doesnt
your rabbit doesnt laugh	your rabbit doesnt laugh IDENT	doesnt
my monkey does read	my monkey does read IDENT	does
our seal does sleep	our seal does sleep IDENT	does
your bird doesnt read	your bird doesnt read IDENT	doesnt
some dog doesnt sleep	some dog doesnt sleep IDENT	doesnt
some seals do smile	some seals do smile IDENT	do
some rabbit does read	some rabbit does read IDENT	does
my yaks dont sleep	my yaks dont sleep IDENT	dont
the seal does smile	the seal does smile IDENT	does
our unicorns do giggle	our unicorns do giggle IDENT	do
my cats do read	my cats do read IDENT	do
some yaks do read	some yaks do read IDENT	do
her unicorns dont smile	her unicorns dont smile IDENT	dont
my unicorns dont giggle	my unicorns dont giggle IDENT	dont
her birds do giggle	her birds do giggle IDENT	do
our seal doesnt laugh	our seal doesnt laugh IDENT	doesnt
her rabbit does sleep	her rabbit does sleep IDENT	does
the rabbit does giggle	the rabbit does giggle IDENT	does
my elephant does giggle	my elephant does giggle IDENT	does
some cat doesnt smile	some cat doesnt smile IDENT	doesnt
some elephant doesnt sleep	some elephant doesnt sleep IDENT	doesnt
our dog does giggle	our dog does giggle IDENT	does
our cats dont laugh	our cats dont laugh IDENT	dont
your dogs do live	your dogs do live IDENT	do
her bird does live	her bird does live IDENT	does
the rabbit doesnt giggle	the rabbit doesnt giggle IDENT	doesnt
the unicorns dont smile	the unicorns dont smile IDENT	dont
my rabbits dont laugh	my rabbits dont laugh IDENT	dont
our dog does live	our dog does live IDENT	does
our cat does live	our cat does live IDENT	does
some unicorns do sleep	some unicorns do sleep IDENT	do
our cat does live	our cat does live IDENT	does
your dog doesnt smile	your dog doesnt smile IDENT	doesnt
some monkeys dont sleep	some monkeys dont sleep IDENT	dont
my cats do smile	my cats do smile IDENT	do
our dogs do giggle	our dogs do giggle IDENT	do
your seal doesnt live	your seal doesnt live IDENT	doesnt
my cats do sleep	my cats do sleep IDENT	do
our birds dont smile	our birds dont smile IDENT	dont
her yaks dont giggle	her yaks dont giggle IDENT	dont
some yak doesnt laugh	some yak doesnt laugh IDENT	doesnt
