does some unicorn giggle ? QUEST	some unicorn does giggle . QUEST	does
does some elephant sleep ? QUEST	some elephant does sleep . QUEST	does
do the cats giggle ? QUEST	the cats do giggle . QUEST	do
doesnt our elephant live ? QUEST	our elephant doesnt live . QUEST	doesnt
do some unicorns smile ? QUEST	some unicorns do smile . QUEST	do
does your rabbit giggle ? QUEST	your rabbit does giggle . QUEST	does
dont her seals sleep ? QUEST	her seals dont sleep . QUEST	dont
do some dogs read ? QUEST	some dogs do read . QUEST	do
doesnt some dog read ? QUEST	some dog doesnt read . QUEST	doesnt
dont her elephants smile ? QUEST	her elephants dont smile . QUEST	dont
dont some elephants smile ? QUEST	some elephants dont smile . QUEST	dont
does the unicorn smile ? QUEST	the unicorn does smile . QUEST	does
does the unicorn sleep ? QUEST	the unicorn does sleep . QUEST	does
do the yaks laugh ? QUEST	the yaks do laugh . QUEST	do
does some elephant live ? QUEST	some elephant does live . QUEST	does
do our monkeys live ? QUEST	our monkeys do live . QUEST	do
does some cat giggle ? QUEST	some cat does giggle . QUEST	does
does some elephant giggle ? QUEST	some elephant does giggle . QUEST	does
doesnt some monkey smile ? QUEST	some monkey doesnt smile . QUEST	doesnt
doesnt the yak sleep ? QUEST	the yak doesnt sleep . QUEST	doesnt
dont your monkeys live ? QUEST	your monkeys dont live . QUEST	dont
dont our seals read ? QUEST	our seals dont read . QUEST	dont
doesnt my bird laugh ? QUEST	my bird doesnt laugh . QUEST	doesnt
doesnt your rabbit sleep ? QUEST	your rabbit doesnt sleep . QUEST	doesnt
does your seal smile ? QUEST	your seal does smile . QUEST	does
does some yak laugh ? QUEST	some yak does laugh . QUEST	does
doesnt the cat read ? QUEST	the cat doesnt read . QUEST	doesnt
dont your dogs smile ? QUEST	your dogs dont smile . QUEST	dont
dont our seals giggle ? QUEST	our seals dont giggle . QUEST	dont
do my monkeys read ? QUEST	my monkeys do read . QUEST	do
dont our birds smile ? QUEST	our birds dont smile . QUEST	dont
does your dog sleep ? QUEST	your dog does sleep . QUEST	does
do your elephants sleep ? QUEST	your elephants do sleep . QUEST	do
do the yaks smile ? QUEST	the yaks do smile . QUEST	do
dont some yaks read ? QUEST	some yaks dont read . QUEST	dont
does some yak sleep ? QUEST	some yak does sleep . QUEST	does
doesnt some rabbit read ? QUEST	some rabbit doesnt read . QUEST	doesnt
do your rabbits smile ? QUEST	your rabbits do smile . QUEST	do
do your yaks sleep ? QUEST	your yaks do sleep . QUEST	do
dont her unicorns sleep ? QUEST	her unicorns dont sleep . QUEST	dont
doesnt your bird laugh ? QUEST	your bird doesnt laugh . QUEST	doesnt
do the monkeys read ? QUEST	the monkeys do read . QUEST	do
dont the monkeys read ? QUEST	the monkeys dont read . QUEST	dont
doesnt our seal giggle ? QUEST	our seal doesnt giggle . QUEST	doesnt
dont our dogs laugh ? QUEST	our dogs dont laugh . QUEST	dont
dont our rabbits giggle ? QUEST	our rabbits dont giggle . QUEST	dont
do some seals giggle ? QUEST	some seals do giggle . QUEST	do
do my yaks sleep ? QUEST	my yaks do sleep . QUEST	do
dont the monkeys read ? QUEST	the monkeys dont read . QUEST	dont
doesnt some rabbit giggle ? QUEST	some rabbit doesnt giggle . QUEST	doesnt
doesnt some seal giggle ? QUEST	some seal doesnt giggle . QUEST	doesnt
doesnt the dog giggle ? QUEST	the dog doesnt giggle . QUEST	doesnt
does my elephant live ? QUEST	my elephant does live . QUEST	does
doesnt the monkey laugh ? QUEST	the monkey doesnt laugh . QUEST	doesnt
dont my monkeys laugh ? QUEST	my monkeys dont laugh . QUEST	dont
does her seal live ? QUEST	her seal does live . QUEST	does
doesnt some unicorn sleep ? QUEST	some unicorn doesnt sleep . QUEST	doesnt
do your seals live ? QUEST	your seals do live . QUEST	do
dont the cats smile ? QUEST	the cats dont smile . QUEST	dont
doesnt some cat giggle ? QUEST	some cat doesnt giggle . QUEST	doesnt
dont some monkeys giggle ? QUEST	some monkeys dont giggle . QUEST	dont
does my yak live ? QUEST	my yak does live . QUEST	does
doesnt your rabbit live ? QUEST	your rabbit doesnt live . QUEST	doesnt
does our yak sleep ? QUEST	our yak does sleep . QUEST	does
does some dog giggle ? QUEST	some dog does giggle . QUEST	does
doesnt my yak giggle ? QUEST	my yak doesnt giggle . QUEST	doesnt
dont my cats giggle ? QUEST	my cats dont giggle . QUEST	dont
doesnt your elephant read ? QUEST	your elephant doesnt read . QUEST	doesnt
dont your seals live ? QUEST	your seals dont live . QUEST	dont
do your elephants read ? QUEST	your elephants do read . QUEST	do
does her monkey smile ? QUEST	her monkey does smile . QUEST	does
doesnt your cat smile ? QUEST	your cat doesnt smile . QUEST	doesnt
dont your birds smile ? QUEST	your birds dont smile . QUEST	dont
does her cat live ? QUEST	her cat does live . QUEST	does
do some monkeys laugh ? QUEST	some monkeys do laugh . QUEST	do
do our dogs smile ? QUEST	our dogs do smile . QUEST	do
dont the rabbits read ? QUEST	the rabbits dont read . QUEST	dont
does some cat read ? QUEST	some cat does read . QUEST	does
do my yaks read ? QUEST	my yaks do read . QUEST	do
doesnt our rabbit laugh ? QUEST	our rabbit doesnt laugh . QUEST	doesnt
do our rabbits laugh ? QUEST	our rabbits do laugh . QUEST	do
dont my elephants laugh ? QUEST	my elephants dont laugh . QUEST	dont
do your cats smile ? QUEST	your cats do smile . QUEST	do
does the unicorn read ? QUEST	the unicorn does read . QUEST	does
doesnt her unicorn laugh ? QUEST	her unicorn doesnt laugh . QUEST	doesnt
dont the dogs laugh ? QUEST	the dogs dont laugh . QUEST	dont
do your rabbits read ? QUEST	your rabbits do read . QUEST	do
does your seal laugh ? QUEST	your seal does laugh . QUEST	does
do the cats laugh ? QUEST	the cats do laugh . QUEST	do
dont her rabbits live ? QUEST	her rabbits dont live . QUEST	dont
does some seal live ? QUEST	some seal does live . QUEST	does
dont my monkeys read ? QUEST	my monkeys dont read . QUEST	dont
dont your rabbits read ? QUEST	your rabbits dont read . QUEST	dont
doesnt your unicorn laugh ? QUEST	your unicorn doesnt laugh . QUEST	doesnt
doesnt your elephant live ? QUEST	your elephant doesnt live . QUEST	doesnt
does some bird giggle ? QUEST	some bird does giggle . QUEST	does
do some elephants giggle ? QUEST	some elephants do giggle . QUEST	do
does the yak laugh ? QUEST	the yak does laugh . QUEST	does
does her yak live ? QUEST	her yak does live . QUEST	does
dont her birds smile ? QUEST	her birds dont smile . QUEST	dont
dont her elephants laugh ? QUEST	her elephants dont laugh . QUEST	dont
doesnt your unicorn smile ? QUEST	your unicorn doesnt smile . QUEST	doesnt
do her elephants laugh ? QUEST	her elephants do laugh . QUEST	do
doesnt her seal live ? QUEST	her seal doesnt live . QUEST	doesnt
does her yak giggle ? QUEST	her yak does giggle . QUEST	does
do the birds smile ? QUEST	the birds do smile . QUEST	do
does our unicorn live ? QUEST	our unicorn does live . QUEST	does
do her monkeys smile ? QUEST	her monkeys do smile . QUEST	do
doesnt our dog read ? QUEST	our dog doesnt read . QUEST	doesnt
doesnt some bird smile ? QUEST	some bird doesnt smile . QUEST	doesnt
do my unicorns sleep ? QUEST	my unicorns do sleep . QUEST	do
do your cats live ? QUEST	your cats do live . QUEST	do
does the yak sleep ? QUEST	the yak does sleep . QUEST	does
dont her unicorns giggle ? QUEST	her unicorns dont giggle . QUEST	dont
doesnt some bird sleep ? QUEST	some bird doesnt sleep . QUEST	doesnt
do our monkeys live ? QUEST	our monkeys do live . QUEST	do
does the elephant smile ? QUEST	the elephant does smile . QUEST	does
doesnt some elephant laugh ? QUEST	some elephant doesnt laugh . QUEST	doesnt
does the cat live ? QUEST	the cat does live . QUEST	does
does the seal live ? QUEST	the seal does live . QUEST	does
do the dogs sleep ? QUEST	the dogs do sleep . QUEST	do
doesnt your elephant read ? QUEST	your elephant doesnt read . QUEST	doesnt
do her cats sleep ? QUEST	her cats do sleep . QUEST	do
does your seal laugh ? QUEST	your seal does laugh . QUEST	does
doesnt some rabbit smile ? QUEST	some rabbit doesnt smile . QUEST	doesnt
dont her monkeys read ? QUEST	her monkeys dont read . QUEST	dont
doesnt her cat laugh ? QUEST	her cat doesnt laugh . QUEST	doesnt
dont my dogs smile ? QUEST	my dogs dont smile . QUEST	dont
does our dog live ? QUEST	our dog does live . QUEST	does
do my elephants live ? QUEST	my elephants do live . QUEST	do
do her unicorns live ? QUEST	her unicorns do live . QUEST	do
dont my elephants read ? QUEST	my elephants dont read . QUEST	dont
does your dog sleep ? QUEST	your dog does sleep . QUEST	does
dont your birds sleep ? QUEST	your birds dont sleep . QUEST	dont
dont her unicorns read ? QUEST	her unicorns dont read . QUEST	dont
dont her dogs smile ? QUEST	her dogs dont smile . QUEST	dont
does some dog sleep ? QUEST	some dog does sleep . QUEST	does
do the cats sleep ? QUEST	the cats do sleep . QUEST	do
dont the birds read ? QUEST	the birds dont read . QUEST	dont
do our elephants live ? QUEST	our elephants do live . QUEST	do
does my monkey read ? QUEST	my monkey does read . QUEST	does
do her unicorns read ? QUEST	her unicorns do read . QUEST	do
do your dogs smile ? QUEST	your dogs do smile . QUEST	do
do the birds live ? QUEST	the birds do live . QUEST	do
doesnt some elephant laugh ? QUEST	some elephant doesnt laugh . QUEST	doesnt
do the cats laugh ? QUEST	the cats do laugh . QUEST	do
dont the birds giggle ? QUEST	the birds dont giggle . QUEST	dont
dont some dogs laugh ? QUEST	some dogs dont laugh . QUEST	dont
dont some dogs read ? QUEST	some dogs dont read . QUEST	dont
do some birds laugh ? QUEST	some birds do laugh . QUEST	do
doesnt my seal read ? QUEST	my seal doesnt read . QUEST	doesnt
does my yak sleep ? QUEST	my yak does sleep . QUEST	does
dont your cats read ? QUEST	your cats dont read . QUEST	dont
does the yak smile ? QUEST	the yak does smile . QUEST	does
do your unicorns laugh ? QUEST	your unicorns do laugh . QUEST	do
doesnt your unicorn giggle ? QUEST	your unicorn doesnt giggle . QUEST	doesnt
dont your rabbits giggle ? QUEST	your rabbits dont giggle . QUEST	dont
doesnt my rabbit read ? QUEST	my rabbit doesnt read . QUEST	doesnt
do her monkeys read ? QUEST	her monkeys do read . QUEST	do
doesnt my bird sleep ? QUEST	my bird doesnt sleep . QUEST	doesnt
doesnt our rabbit read ? QUEST	our rabbit doesnt read . QUEST	doesnt
does your dog sleep ? QUEST	your dog does sleep . QUEST	does
dont your dogs giggle ? QUEST	your dogs dont giggle . QUEST	dont
does some rabbit giggle ? QUEST	some rabbit does giggle . QUEST	does
does my yak smile ? QUEST	my yak does smile . QUEST	does
does my yak sleep ? QUEST	my yak does sleep . QUEST	does
do your yaks live ? QUEST	your yaks do live . QUEST	do
does her rabbit live ? QUEST	her rabbit does live . QUEST	does
do her yaks live ? QUEST	her yaks do live . QUEST	do
dont some rabbits live ? QUEST	some rabbits dont live . QUEST	dont
does her seal sleep ? QUEST	her seal does sleep . QUEST	does
doesnt my cat laugh ? QUEST	my cat doesnt laugh . QUEST	doesnt
dont our seals read ? QUEST	our seals dont read . QUEST	dont
dont some unicorns sleep ? QUEST	some unicorns dont sleep . QUEST	dont
does your elephant live ? QUEST	your elephant does live . QUEST	does
do my birds read ? QUEST	my birds do read . QUEST	do
dont our unicorns giggle ? QUEST	our unicorns dont giggle . QUEST	dont
dont our cats sleep ? QUEST	our cats dont sleep . QUEST	dont
dont the birds sleep ? QUEST	the birds dont sleep . QUEST	dont
dont your dogs sleep ? QUEST	your dogs dont sleep . QUEST	dont
does our bird live ? QUEST	our bird does live . QUEST	does
does your monkey live ? QUEST	your monkey does live . QUEST	does
do my monkeys live ? QUEST	my monkeys do live . QUEST	do
does her monkey smile ? QUEST	her monkey does smile . QUEST	does
does some cat sleep ? QUEST	some cat does sleep . QUEST	does
doesnt my unicorn giggle ? QUEST	my unicorn doesnt giggle . QUEST	doesnt
doesnt your elephant giggle ? QUEST	your elephant doesnt giggle . QUEST	doesnt
dont your unicorns giggle ? QUEST	your unicorns dont giggle . QUEST	dont
dont the rabbits sleep ? QUEST	the rabbits dont sleep . QUEST	dont
does your bird smile ? QUEST	your bird does smile . QUEST	does
doesnt our bird sleep ? QUEST	our bird doesnt sleep . QUEST	doesnt
dont your monkeys giggle ? QUEST	your monkeys dont giggle . QUEST	dont
does her rabbit giggle ? QUEST	her rabbit does giggle . QUEST	does
dont her rabbits giggle ? QUEST	her rabbits dont giggle . QUEST	dont
do my dogs live ? QUEST	my dogs do live . QUEST	do
do the birds laugh ? QUEST	the birds do laugh . QUEST	do
doesnt her elephant laugh ? QUEST	her elephant doesnt laugh . QUEST	doesnt
doesnt some seal laugh ? QUEST	some seal doesnt laugh . QUEST	doesnt
dont our yaks laugh ? QUEST	our yaks dont laugh . QUEST	dont
does our monkey live ? QUEST	our monkey does live . QUEST	does
dont some seals read ? QUEST	some seals dont read . QUEST	dont
dont her elephants sleep ? QUEST	her elephants dont sleep . QUEST	dont
do some dogs laugh ? QUEST	some dogs do laugh . QUEST	do
do some birds read ? QUEST	some birds do read . QUEST	do
doesnt our dog live ? QUEST	our dog doesnt live . QUEST	doesnt
doesnt some monkey read ? QUEST	some monkey doesnt read . QUEST	doesnt
dont my elephants sleep ? QUEST	my elephants dont sleep . QUEST	dont
do your birds sleep ? QUEST	your birds do sleep . QUEST	do
dont the dogs live ? QUEST	the dogs dont live . QUEST	dont
does our elephant smile ? QUEST	our elephant does smile . QUEST	does
does our cat laugh ? QUEST	our cat does laugh . QUEST	does
does some monkey laugh ? QUEST	some monkey does laugh . QUEST	does
does some dog laugh ? QUEST	some dog does laugh . QUEST	does
doesnt our unicorn smile ? QUEST	our unicorn doesnt smile . QUEST	doesnt
doesnt the unicorn smile ? QUEST	the unicorn doesnt smile . QUEST	doesnt
dont our unicorns read ? QUEST	our unicorns dont read . QUEST	dont
doesnt some dog smile ? QUEST	some dog doesnt smile . QUEST	doesnt
dont some yaks smile ? QUEST	some yaks dont smile . QUEST	dont
doesnt some unicorn giggle ? QUEST	some unicorn doesnt giggle . QUEST	doesnt
do some monkeys laugh ? QUEST	some monkeys do laugh . QUEST	do
does her cat read ? QUEST	her cat does read . QUEST	does
does our yak laugh ? QUEST	our yak does laugh . QUEST	does
doesnt her bird laugh ? QUEST	her bird doesnt laugh . QUEST	doesnt
does my unicorn read ? QUEST	my unicorn does read . QUEST	does
dont some dogs read ? QUEST	some dogs dont read . QUEST	dont
doesnt your monkey smile ? QUEST	your monkey doesnt smile . QUEST	doesnt
dont her dogs read ? QUEST	her dogs dont read . QUEST	dont
doesnt some rabbit giggle ? QUEST	some rabbit doesnt giggle . QUEST	doesnt
does some cat laugh ? QUEST	some cat does laugh . QUEST	does
do her yaks smile ? QUEST	her yaks do smile . QUEST	do
does my yak sleep ? QUEST	my yak does sleep . QUEST	does
doesnt her yak read ? QUEST	her yak doesnt read . QUEST	doesnt
dont her cats sleep ? QUEST	her cats dont sleep . QUEST	dont
dont my cats read ? QUEST	my cats dont read . QUEST	dont
does your cat read ? QUEST	your cat does read . QUEST	does
do our elephants sleep ? QUEST	our elephants do sleep . QUEST	do
does our bird sleep ? QUEST	our bird does sleep . QUEST	does
do our dogs sleep ? QUEST	our dogs do sleep . QUEST	do
dont my dogs sleep ? QUEST	my dogs dont sleep . QUEST	dont
does some rabbit read ? QUEST	some rabbit does read . QUEST	does
dont the unicorns sleep ? QUEST	the unicorns dont sleep . QUEST	dont
do our cats smile ? QUEST	our cats do smile . QUEST	do
does our rabbit giggle ? QUEST	our rabbit does giggle . QUEST	does
does the cat smile ? QUEST	the cat does smile . QUEST	does
does your monkey live ? QUEST	your monkey does live . QUEST	does
doesnt your yak smile ? QUEST	your yak doesnt smile . QUEST	doesnt
doesnt my rabbit laugh ? QUEST	my rabbit doesnt laugh . QUEST	doesnt
do the rabbits sleep ? QUEST	the rabbits do sleep . QUEST	do
does our dog giggle ? QUEST	our dog does giggle . QUEST	does
doesnt some cat smile ? QUEST	some cat doesnt smile . QUEST	doesnt
do some yaks smile ? QUEST	some yaks do smile . QUEST	do
does your rabbit smile ? QUEST	your rabbit does smile . QUEST	does
doesnt my monkey live ? QUEST	my monkey doesnt live . QUEST	doesnt
do your elephants laugh ? QUEST	your elephants do laugh . QUEST	do
doesnt some monkey smile ? QUEST	some monkey doesnt smile . QUEST	doesnt
dont your monkeys laugh ? QUEST	your monkeys dont laugh . QUEST	dont
doesnt some rabbit smile ? QUEST	some rabbit doesnt smile . QUEST	doesnt
doesnt some monkey smile ? QUEST	some monkey doesnt smile . QUEST	doesnt
doesnt my monkey smile ? QUEST	my monkey doesnt smile . QUEST	doesnt
does the bird live ? QUEST	the bird does live . QUEST	does
does your dog laugh ? QUEST	your dog does laugh . QUEST	does
dont your dogs laugh ? QUEST	your dogs dont laugh . QUEST	dont
dont my elephants read ? QUEST	my elephants dont read . QUEST	dont
doesnt our cat giggle ? QUEST	our cat doesnt giggle . QUEST	doesnt
does the elephant smile ? QUEST	the elephant does smile . QUEST	does
does your elephant smile ? QUEST	your elephant does smile . QUEST	does
does some bird giggle ? QUEST	some bird does giggle . QUEST	does
dont some dogs read ? QUEST	some dogs dont read . QUEST	dont
doesnt the cat laugh ? QUEST	the cat doesnt laugh . QUEST	doesnt
do my yaks laugh ? QUEST	my yaks do laugh . QUEST	do
does the elephant live ? QUEST	the elephant does live . QUEST	does
doesnt her unicorn live ? QUEST	her unicorn doesnt live . QUEST	doesnt
doesnt some rabbit giggle ? QUEST	some rabbit doesnt giggle . QUEST	doesnt
does the monkey live ? QUEST	the monkey does live . QUEST	does
does some monkey read ? QUEST	some monkey does read . QUEST	does
dont my unicorns read ? QUEST	my unicorns dont read . QUEST	dont
dont my seals live ? QUEST	my seals dont live . QUEST	dont
doesnt our elephant live ? QUEST	our elephant doesnt live . QUEST	doesnt
does our rabbit sleep ? QUEST	our rabbit does sleep . QUEST	does
doesnt our dog sleep ? QUEST	our dog doesnt sleep . QUEST	doesnt
do some dogs read ? QUEST	some dogs do read . QUEST	do
dont the seals smile ? QUEST	the seals dont smile . QUEST	dont
dont my dogs giggle ? QUEST	my dogs dont giggle . QUEST	dont
do our yaks live ? QUEST	our yaks do live . QUEST	do
dont the rabbits sleep ? QUEST	the rabbits dont sleep . QUEST	dont
does some bird smile ? QUEST	some bird does smile . QUEST	does
doesnt her seal giggle ? QUEST	her seal doesnt giggle . QUEST	doesnt
doesnt your bird laugh ? QUEST	your bird doesnt laugh . QUEST	doesnt
does some elephant giggle ? QUEST	some elephant does giggle . QUEST	does
does the seal live ? QUEST	the seal does live . QUEST	does
do my dogs live ? QUEST	my dogs do live . QUEST	do
doesnt some dog smile ? QUEST	some dog doesnt smile . QUEST	doesnt
dont some dogs laugh ? QUEST	some dogs dont laugh . QUEST	dont
does the seal smile ? QUEST	the seal does smile . QUEST	does
does her monkey sleep ? QUEST	her monkey does sleep . QUEST	does
does your elephant giggle ? QUEST	your elephant does giggle . QUEST	does
do your dogs laugh ? QUEST	your dogs do laugh . QUEST	do
do the elephants read ? QUEST	the elephants do read . QUEST	do
doesnt the seal giggle ? QUEST	the seal doesnt giggle . QUEST	doesnt
doesnt my unicorn smile ? QUEST	my unicorn doesnt smile . QUEST	doesnt
does her cat read ? QUEST	her cat does read . QUEST	does
doesnt her yak smile ? QUEST	her yak doesnt smile . QUEST	doesnt
dont your unicorns smile ? QUEST	your unicorns dont smile . QUEST	dont
dont your rabbits sleep ? QUEST	your rabbits dont sleep . QUEST	dont
doesnt the cat laugh ? QUEST	the cat doesnt laugh . QUEST	doesnt
does your monkey read ? QUEST	your monkey does read . QUEST	does
does your rabbit sleep ? QUEST	your rabbit does sleep . QUEST	does
do my birds laugh ? QUEST	my birds do laugh . QUEST	do
does her unicorn giggle ? QUEST	her unicorn does giggle . QUEST	does
do our monkeys laugh ? QUEST	our monkeys do laugh . QUEST	do
do my elephants laugh ? QUEST	my elephants do laugh . QUEST	do
dont the yaks laugh ? QUEST	the yaks dont laugh . QUEST	dont
doesnt my bird laugh ? QUEST	my bird doesnt laugh . QUEST	doesnt
do the dogs smile ? QUEST	the dogs do smile . QUEST	do
dont the rabbits sleep ? QUEST	the rabbits dont sleep . QUEST	dont
doesnt some yak giggle ? QUEST	some yak doesnt giggle . QUEST	doesnt
do my cats giggle ? QUEST	my cats do giggle . QUEST	do
doesnt the monkey smile ? QUEST	the monkey doesnt smile . QUEST	doesnt
dont her unicorns live ? QUEST	her unicorns dont live . QUEST	dont
dont the cats smile ? QUEST	the cats dont smile . QUEST	dont
does my bird read ? QUEST	my bird does read . QUEST	does
doesnt the seal laugh ? QUEST	the seal doesnt laugh . QUEST	doesnt
doesnt the seal smile ? QUEST	the seal doesnt smile . QUEST	doesnt
does your rabbit read ? QUEST	your rabbit does read . QUEST	does
does the yak sleep ? QUEST	the yak does sleep . QUEST	does
dont your unicorns laugh ? QUEST	your unicorns dont laugh . QUEST	dont
doesnt our monkey read ? QUEST	our monkey doesnt read . QUEST	doesnt
doesnt the monkey read ? QUEST	the monkey doesnt read . QUEST	doesnt
does her cat read ? QUEST	her cat does read . QUEST	does
do her cats sleep ? QUEST	her cats do sleep . QUEST	do
dont my yaks sleep ? QUEST	my yaks dont sleep . QUEST	dont
doesnt the unicorn laugh ? QUEST	the unicorn doesnt laugh . QUEST	doesnt
does the unicorn giggle ? QUEST	the unicorn does giggle . QUEST	does
does your bird giggle ? QUEST	your bird does giggle . QUEST	does
does my dog read ? QUEST	my dog does read . QUEST	does
does my dog giggle ? QUEST	my dog does giggle . QUEST	does
does the yak giggle ? QUEST	the yak does giggle . QUEST	does
do my elephants giggle ? QUEST	my elephants do giggle . QUEST	do
do my rabbits giggle ? QUEST	my rabbits do giggle . QUEST	do
do our cats read ? QUEST	our cats do read . QUEST	do
dont her unicorns live ? QUEST	her unicorns dont live . QUEST	dont
doesnt the unicorn live ? QUEST	the unicorn doesnt live . QUEST	doesnt
does the rabbit read ? QUEST	the rabbit does read . QUEST	does
doesnt her yak read ? QUEST	her yak doesnt read . QUEST	doesnt
does my rabbit smile ? QUEST	my rabbit does smile . QUEST	does
dont your elephants smile ? QUEST	your elephants dont smile . QUEST	dont
dont our dogs laugh ? QUEST	our dogs dont laugh . QUEST	dont
does our bird laugh ? QUEST	our bird does laugh . QUEST	does
does your elephant read ? QUEST	your elephant does read . QUEST	does
do your seals smile ? QUEST	your seals do smile . QUEST	do
do your dogs sleep ? QUEST	your dogs do sleep . QUEST	do
dont the monkeys sleep ? QUEST	the monkeys dont sleep . QUEST	dont
do some elephants giggle ? QUEST	some elephants do giggle . QUEST	do
does the unicorn giggle ? QUEST	the unicorn does giggle . QUEST	does
doesnt my bird giggle ? QUEST	my bird doesnt giggle . QUEST	doesnt
dont some birds read ? QUEST	some birds dont read . QUEST	dont
does my monkey sleep ? QUEST	my monkey does sleep . QUEST	does
does our elephant sleep ? QUEST	our elephant does sleep . QUEST	does
doesnt our yak sleep ? QUEST	our yak doesnt sleep . QUEST	doesnt
dont the monkeys sleep ? QUEST	the monkeys dont sleep . QUEST	dont
dont the cats sleep ? QUEST	the cats dont sleep . QUEST	dont
do my rabbits laugh ? QUEST	my rabbits do laugh . QUEST	do
dont the dogs sleep ? QUEST	the dogs dont sleep . QUEST	dont
do her elephants laugh ? QUEST	her elephants do laugh . QUEST	do
doesnt her unicorn giggle ? QUEST	her unicorn doesnt giggle . QUEST	doesnt
dont her rabbits smile ? QUEST	her rabbits dont smile . QUEST	dont
doesnt her dog laugh ? QUEST	her dog doesnt laugh . QUEST	doesnt
doesnt the rabbit smile ? QUEST	the rabbit doesnt smile . QUEST	doesnt
does her seal smile ? QUEST	her seal does smile . QUEST	does
does my elephant smile ? QUEST	my elephant does smile . QUEST	does
doesnt her rabbit live ? QUEST	her rabbit doesnt live . QUEST	doesnt
do your seals giggle ? QUEST	your seals do giggle . QUEST	do
dont her rabbits live ? QUEST	her rabbits dont live . QUEST	dont
does her rabbit sleep ? QUEST	her rabbit does sleep . QUEST	does
does the rabbit laugh ? QUEST	the rabbit does laugh . QUEST	does
do our birds live ? QUEST	our birds do live . QUEST	do
do my rabbits live ? QUEST	my rabbits do live . QUEST	do
does her yak laugh ? QUEST	her yak does laugh . QUEST	does
doesnt her elephant giggle ? QUEST	her elephant doesnt giggle . QUEST	doesnt
do her unicorns read ? QUEST	her unicorns do read . QUEST	do
dont the elephants giggle ? QUEST	the elephants dont giggle . QUEST	dont
doesnt her unicorn read ? QUEST	her unicorn doesnt read . QUEST	doesnt
doesnt some yak smile ? QUEST	some yak doesnt smile . QUEST	doesnt
do some birds giggle ? QUEST	some birds do giggle . QUEST	do
does some dog sleep ? QUEST	some dog does sleep . QUEST	does
dont our cats sleep ? QUEST	our cats dont sleep . QUEST	dont
do your yaks read ? QUEST	your yaks do read . QUEST	do
does some dog smile ? QUEST	some dog does smile . QUEST	does
do the rabbits giggle ? QUEST	the rabbits do giggle . QUEST	do
does the dog read ? QUEST	the dog does read . QUEST	does
dont my unicorns read ? QUEST	my unicorns dont read . QUEST	dont
dont our seals sleep ? QUEST	our seals dont sleep . QUEST	dont
does my dog smile ? QUEST	my dog does smile . QUEST	does
do the birds smile ? QUEST	the birds do smile . QUEST	do
doesnt our unicorn giggle ? QUEST	our unicorn doesnt giggle . QUEST	doesnt
does your yak live ? QUEST	your yak does live . QUEST	does
dont your dogs live ? QUEST	your dogs dont live . QUEST	dont
do the dogs read ? QUEST	the dogs do read . QUEST	do
do our seals read ? QUEST	our seals do read . QUEST	do
doesnt some yak giggle ? QUEST	some yak doesnt giggle . QUEST	doesnt
doesnt the bird smile ? QUEST	the bird doesnt smile . QUEST	doesnt
dont your monkeys smile ? QUEST	your monkeys dont smile . QUEST	dont
dont her yaks laugh ? QUEST	her yaks dont laugh . QUEST	dont
dont the unicorns sleep ? QUEST	the unicorns dont sleep . QUEST	dont
dont some birds smile ? QUEST	some birds dont smile . QUEST	dont
does the yak sleep ? QUEST	the yak does sleep . QUEST	does
dont the seals sleep ? QUEST	the seals dont sleep . QUEST	dont
do the elephants sleep ? QUEST	the elephants do sleep . QUEST	do
dont her dogs laugh ? QUEST	her dogs dont laugh . QUEST	dont
dont our yaks giggle ? QUEST	our yaks dont giggle . QUEST	dont
doesnt the unicorn sleep ? QUEST	the unicorn doesnt sleep . QUEST	doesnt
does some yak sleep ? QUEST	some yak does sleep . QUEST	does
do some monkeys sleep ? QUEST	some monkeys do sleep . QUEST	do
dont our rabbits giggle ? QUEST	our rabbits dont giggle . QUEST	dont
do her rabbits live ? QUEST	her rabbits do live . QUEST	do
does her dog smile ? QUEST	her dog does smile . QUEST	does
dont your cats giggle ? QUEST	your cats dont giggle . QUEST	dont
doesnt her unicorn smile ? QUEST	her unicorn doesnt smile . QUEST	doesnt
does her cat sleep ? QUEST	her cat does sleep . QUEST	does
dont my cats sleep ? QUEST	my cats dont sleep . QUEST	dont
do the elephants sleep ? QUEST	the elephants do sleep . QUEST	do
does our cat read ? QUEST	our cat does read . QUEST	does
do some seals giggle ? QUEST	some seals do giggle . QUEST	do
do some rabbits live ? QUEST	some rabbits do live . QUEST	do
does your dog laugh ? QUEST	your dog does laugh . QUEST	does
do some elephants read ? QUEST	some elephants do read . QUEST	do
doesnt your monkey sleep ? QUEST	your monkey doesnt sleep . QUEST	doesnt
doesnt her yak sleep ? QUEST	her yak doesnt sleep . QUEST	doesnt
does some elephant laugh ? QUEST	some elephant does laugh . QUEST	does
dont my cats laugh ? QUEST	my cats dont laugh . QUEST	dont
dont some cats read ? QUEST	some cats dont read . QUEST	dont
dont some cats laugh ? QUEST	some cats dont laugh . QUEST	dont
doesnt your bird sleep ? QUEST	your bird doesnt sleep . QUEST	doesnt
dont her monkeys read ? QUEST	her monkeys dont read . QUEST	dont
doesnt my bird smile ? QUEST	my bird doesnt smile . QUEST	doesnt
does my monkey live ? QUEST	my monkey does live . QUEST	does
dont your rabbits smile ? QUEST	your rabbits dont smile . QUEST	dont
does her dog live ? QUEST	her dog does live . QUEST	does
dont my seals read ? QUEST	my seals dont read . QUEST	dont
doesnt your seal smile ? QUEST	your seal doesnt smile . QUEST	doesnt
do your birds giggle ? QUEST	your birds do giggle . QUEST	do
doesnt the seal smile ? QUEST	the seal doesnt smile . QUEST	doesnt
do her monkeys giggle ? QUEST	her monkeys do giggle . QUEST	do
doesnt our yak smile ? QUEST	our yak doesnt smile . QUEST	doesnt
does some monkey read ? QUEST	some monkey does read . QUEST	does
dont your monkeys read ? QUEST	your monkeys dont read . QUEST	dont
doesnt your cat giggle ? QUEST	your cat doesnt giggle . QUEST	doesnt
does our monkey read ? QUEST	our monkey does read . QUEST	does
do our yaks laugh ? QUEST	our yaks do laugh . QUEST	do
dont our yaks read ? QUEST	our yaks dont read . QUEST	dont
do some seals smile ? QUEST	some seals do smile . QUEST	do
do my dogs live ? QUEST	my dogs do live . QUEST	do
doesnt our yak laugh ? QUEST	our yak doesnt laugh . QUEST	doesnt
does the bird giggle ? QUEST	the bird does giggle . QUEST	does
do some cats sleep ? QUEST	some cats do sleep . QUEST	do
does her dog live ? QUEST	her dog does live . QUEST	does
doesnt our bird smile ? QUEST	our bird doesnt smile . QUEST	doesnt
doesnt the dog live ? QUEST	the dog doesnt live . QUEST	doesnt
does our bird live ? QUEST	our bird does live . QUEST	does
does our rabbit read ? QUEST	our rabbit does read . QUEST	does
do our rabbits read ? QUEST	our rabbits do read . QUEST	do
dont her rabbits read ? QUEST	her rabbits dont read . QUEST	dont
does our yak laugh ? QUEST	our yak does laugh . QUEST	does
dont our monkeys smile ? QUEST	our monkeys dont smile . QUEST	dont
do my seals live ? QUEST	my seals do live . QUEST	do
dont the dogs smile ? QUEST	the dogs dont smile . QUEST	dont
doesnt the bird sleep ? QUEST	the bird doesnt sleep . QUEST	doesnt
do my monkeys laugh ? QUEST	my monkeys do laugh . QUEST	do
do our yaks sleep ? QUEST	our yaks do sleep . QUEST	do
does my dog read ? QUEST	my dog does read . QUEST	does
doesnt her bird live ? QUEST	her bird doesnt live . QUEST	doesnt
doesnt my dog laugh ? QUEST	my dog doesnt laugh . QUEST	doesnt
dont her dogs giggle ? QUEST	her dogs dont giggle . QUEST	dont
doesnt my bird smile ? QUEST	my bird doesnt smile . QUEST	doesnt
doesnt some bird live ? QUEST	some bird doesnt live . QUEST	doesnt
doesnt the cat smile ? QUEST	the cat doesnt smile . QUEST	doesnt
dont our yaks smile ? QUEST	our yaks dont smile . QUEST	dont
dont your monkeys live ? QUEST	your monkeys dont live . QUEST	dont
does her yak sleep ? QUEST	her yak does sleep . QUEST	does
do your rabbits sleep ? QUEST	your rabbits do sleep . QUEST	do
dont her rabbits laugh ? QUEST	her rabbits dont laugh . QUEST	dont
does the seal giggle ? QUEST	the seal does giggle . QUEST	does
do her rabbits sleep ? QUEST	her rabbits do sleep . QUEST	do
dont my dogs read ? QUEST	my dogs dont read . QUEST	dont
do our monkeys read ? QUEST	our monkeys do read . QUEST	do
does her elephant read ? QUEST	her elephant does read . QUEST	does
does her monkey live ? QUEST	her monkey does live . QUEST	does
does some bird read ? QUEST	some bird does read . QUEST	does
do your yaks laugh ? QUEST	your yaks do laugh . QUEST	do
doesnt our dog sleep ? QUEST	our dog doesnt sleep . QUEST	doesnt
do our cats sleep ? QUEST	our cats do sleep . QUEST	do
does her rabbit smile ? QUEST	her rabbit does smile . QUEST	does
doesnt the elephant laugh ? QUEST	the elephant doesnt laugh . QUEST	doesnt
doesnt the unicorn live ? QUEST	the unicorn doesnt live . QUEST	doesnt
dont our elephants read ? QUEST	our elephants dont read . QUEST	dont
doesnt the monkey smile ? QUEST	the monkey doesnt smile . QUEST	doesnt
doesnt some monkey smile ? QUEST	some monkey doesnt smile . QUEST	doesnt
dont the seals read ? QUEST	the seals dont read . QUEST	dont
does my bird laugh ? QUEST	my bird does laugh . QUEST	does
does my yak live ? QUEST	my yak does live . QUEST	does
does some seal giggle ? QUEST	some seal does giggle . QUEST	does
does my bird sleep ? QUEST	my bird does sleep . QUEST	does
doesnt my bird sleep ? QUEST	my bird doesnt sleep . QUEST	doesnt
doesnt some dog laugh ? QUEST	some dog doesnt laugh . QUEST	doesnt
dont the unicorns read ? QUEST	the unicorns dont read . QUEST	dont
does our monkey read ? QUEST	our monkey does read . QUEST	does
do her dogs smile ? QUEST	her dogs do smile . QUEST	do
dont your seals smile ? QUEST	your seals dont smile . QUEST	dont
dont my seals giggle ? QUEST	my seals dont giggle . QUEST	dont
does our elephant read ? QUEST	our elephant does read . QUEST	does
does her dog giggle ? QUEST	her dog does giggle . QUEST	does
does some bird read ? QUEST	some bird does read . QUEST	does
doesnt our dog sleep ? QUEST	our dog doesnt sleep . QUEST	doesnt
doesnt my bird live ? QUEST	my bird doesnt live . QUEST	doesnt
doesnt the yak giggle ? QUEST	the yak doesnt giggle . QUEST	doesnt
does my yak giggle ? QUEST	my yak does giggle . QUEST	does
dont her elephants sleep ? QUEST	her elephants dont sleep . QUEST	dont
doesnt our seal smile ? QUEST	our seal doesnt smile . QUEST	doesnt
doesnt our cat smile ? QUEST	our cat doesnt smile . QUEST	doesnt
doesnt your bird read ? QUEST	your bird doesnt read . QUEST	doesnt
does her bird giggle ? QUEST	her bird does giggle . QUEST	does
doesnt your bird smile ? QUEST	your bird doesnt smile . QUEST	doesnt
dont her unicorns smile ? QUEST	her unicorns dont smile . QUEST	dont
does the dog sleep ? QUEST	the dog does sleep . QUEST	does
doesnt my yak read ? QUEST	my yak doesnt read . QUEST	doesnt
dont some rabbits laugh ? QUEST	some rabbits dont laugh . QUEST	dont
does my elephant sleep ? QUEST	my elephant does sleep . QUEST	does
does your bird live ? QUEST	your bird does live . QUEST	does
doesnt her dog live ? QUEST	her dog doesnt live . QUEST	doesnt
does the seal live ? QUEST	the seal does live . QUEST	does
dont our unicorns live ? QUEST	our unicorns dont live . QUEST	dont
doesnt her monkey giggle ? QUEST	her monkey doesnt giggle . QUEST	doesnt
do our unicorns sleep ? QUEST	our unicorns do sleep . QUEST	do
doesnt the monkey read ? QUEST	the monkey doesnt read . QUEST	doesnt
do the yaks sleep ? QUEST	the yaks do sleep . QUEST	do
dont your elephants read ? QUEST	your elephants dont read . QUEST	dont
dont the dogs smile ? QUEST	the dogs dont smile . QUEST	dont
does your monkey giggle ? QUEST	your monkey does giggle . QUEST	does
doesnt your unicorn read ? QUEST	your unicorn doesnt read . QUEST	doesnt
do our rabbits live ? QUEST	our rabbits do live . QUEST	do
do her elephants smile ? QUEST	her elephants do smile . QUEST	do
doesnt our bird sleep ? QUEST	our bird doesnt sleep . QUEST	doesnt
doesnt my rabbit live ? QUEST	my rabbit doesnt live . QUEST	doesnt
does her bird read ? QUEST	her bird does read . QUEST	does
doesnt our dog read ? QUEST	our dog doesnt read . QUEST	doesnt
dont her seals giggle ? QUEST	her seals dont giggle . QUEST	dont
do our seals read ? QUEST	our seals do read . QUEST	do
dont the seals giggle ? QUEST	the seals dont giggle . QUEST	dont
do the dogs live ? QUEST	the dogs do live . QUEST	do
doesnt our bird smile ? QUEST	our bird doesnt smile . QUEST	doesnt
does your dog giggle ? QUEST	your dog does giggle . QUEST	does
do your cats giggle ? QUEST	your cats do giggle . QUEST	do
doesnt our bird sleep ? QUEST	our bird doesnt sleep . QUEST	doesnt
doesnt our elephant live ? QUEST	our elephant doesnt live . QUEST	doesnt
do her seals live ? QUEST	her seals do live . QUEST	do
do her yaks giggle ? QUEST	her yaks do giggle . QUEST	do
dont your seals live ? QUEST	your seals dont live . QUEST	dont
dont my monkeys giggle ? QUEST	my monkeys dont giggle . QUEST	dont
does the elephant giggle ? QUEST	the elephant does giggle . QUEST	does
do our yaks read ? QUEST	our yaks do read . QUEST	do
does our dog smile ? QUEST	our dog does smile . QUEST	does
does our seal giggle ? QUEST	our seal does giggle . QUEST	does
dont her dogs laugh ? QUEST	her dogs dont laugh . QUEST	dont
does the cat read ? QUEST	the cat does read . QUEST	does
do her birds sleep ? QUEST	her birds do sleep . QUEST	do
does your dog giggle ? QUEST	your dog does giggle . QUEST	does
do your elephants giggle ? QUEST	your elephants do giggle . QUEST	do
doesnt my bird live ? QUEST	my bird doesnt live . QUEST	doesnt
does the rabbit laugh ? QUEST	the rabbit does laugh . QUEST	does
doesnt your dog live ? QUEST	your dog doesnt live . QUEST	doesnt
dont your unicorns laugh ? QUEST	your unicorns dont laugh . QUEST	dont
does my monkey giggle ? QUEST	my monkey does giggle . QUEST	does
dont my rabbits giggle ? QUEST	my rabbits dont giggle . QUEST	dont
dont some dogs live ? QUEST	some dogs dont live . QUEST	dont
does my seal laugh ? QUEST	my seal does laugh . QUEST	does
do my monkeys laugh ? QUEST	my monkeys do laugh . QUEST	do
do our unicorns laugh ? QUEST	our unicorns do laugh . QUEST	do
do our unicorns giggle ? QUEST	our unicorns do giggle . QUEST	do
doesnt your yak sleep ? QUEST	your yak doesnt sleep . QUEST	doesnt
do your dogs read ? QUEST	your dogs do read . QUEST	do
dont your elephants read ? QUEST	your elephants dont read . QUEST	dont
doesnt your yak read ? QUEST	your yak doesnt read . QUEST	doesnt
does some bird sleep ? QUEST	some bird does sleep . QUEST	does
doesnt our elephant smile ? QUEST	our elephant doesnt smile . QUEST	doesnt
do our elephants smile ? QUEST	our elephants do smile . QUEST	do
does your rabbit read ? QUEST	your rabbit does read . QUEST	does
does her rabbit smile ? QUEST	her rabbit does smile . QUEST	does
do your unicorns smile ? QUEST	your unicorns do smile . QUEST	do
doesnt her rabbit read ? QUEST	her rabbit doesnt read . QUEST	doesnt
do some rabbits read ? QUEST	some rabbits do read . QUEST	do
doesnt my monkey sleep ? QUEST	my monkey doesnt sleep . QUEST	doesnt
doesnt some dog giggle ? QUEST	some dog doesnt giggle . QUEST	doesnt
dont our seals laugh ? QUEST	our seals dont laugh . QUEST	dont
dont her dogs laugh ? QUEST	her dogs dont laugh . QUEST	dont
doesnt my cat sleep ? QUEST	my cat doesnt sleep . QUEST	doesnt
dont the dogs sleep ? QUEST	the dogs dont sleep . QUEST	dont
doesnt her unicorn laugh ? QUEST	her unicorn doesnt laugh . QUEST	doesnt
does your dog read ? QUEST	your dog does read . QUEST	does
dont the elephants read ? QUEST	the elephants dont read . QUEST	dont
doesnt our yak smile ? QUEST	our yak doesnt smile . QUEST	doesnt
do some monkeys smile ? QUEST	some monkeys do smile . QUEST	do
dont her unicorns giggle ? QUEST	her unicorns dont giggle . QUEST	dont
does the seal laugh ? QUEST	the seal does laugh . QUEST	does
dont the rabbits smile ? QUEST	the rabbits dont smile . QUEST	dont
does some rabbit smile ? QUEST	some rabbit does smile . QUEST	does
doesnt her rabbit read ? QUEST	her rabbit doesnt read . QUEST	doesnt
does your unicorn read ? QUEST	your unicorn does read . QUEST	does
do some monkeys laugh ? QUEST	some monkeys do laugh . QUEST	do
doesnt the unicorn sleep ? QUEST	the unicorn doesnt sleep . QUEST	doesnt
do some birds live ? QUEST	some birds do live . QUEST	do
does the seal read ? QUEST	the seal does read . QUEST	does
doesnt your dog sleep ? QUEST	your dog doesnt sleep . QUEST	doesnt
doesnt the dog smile ? QUEST	the dog doesnt smile . QUEST	doesnt
does our dog smile ? QUEST	our dog does smile . QUEST	does
doesnt my monkey sleep ? QUEST	my monkey doesnt sleep . QUEST	doesnt
does her bird read ? QUEST	her bird does read . QUEST	does
dont the monkeys read ? QUEST	the monkeys dont read . QUEST	dont
do her monkeys read ? QUEST	her monkeys do read . QUEST	do
does some unicorn live ? QUEST	some unicorn does live . QUEST	does
do your dogs sleep ? QUEST	your dogs do sleep . QUEST	do
dont her cats giggle ? QUEST	her cats dont giggle . QUEST	dont
does my bird giggle ? QUEST	my bird does giggle . QUEST	does
does the bird laugh ? QUEST	the bird does laugh . QUEST	does
dont the rabbits smile ? QUEST	the rabbits dont smile . QUEST	dont
does the yak live ? QUEST	the yak does live . QUEST	does
does some cat laugh ? QUEST	some cat does laugh . QUEST	does
does her monkey giggle ? QUEST	her monkey does giggle . QUEST	does
dont her dogs giggle ? QUEST	her dogs dont giggle . QUEST	dont
dont your unicorns giggle ? QUEST	your unicorns dont giggle . QUEST	dont
does our elephant read ? QUEST	our elephant does read . QUEST	does
does your seal read ? QUEST	your seal does read . QUEST	does
do our rabbits read ? QUEST	our rabbits do read . QUEST	do
do our elephants read ? QUEST	our elephants do read . QUEST	do
doesnt some yak smile ? QUEST	some yak doesnt smile . QUEST	doesnt
doesnt the cat laugh ? QUEST	the cat doesnt laugh . QUEST	doesnt
dont the birds laugh ? QUEST	the birds dont laugh . QUEST	dont
do our elephants sleep ? QUEST	our elephants do sleep . QUEST	do
do our elephants live ? QUEST	our elephants do live . QUEST	do
does your monkey laugh ? QUEST	your monkey does laugh . QUEST	does
does your cat live ? QUEST	your cat does live . QUEST	does
dont our elephants giggle ? QUEST	our elephants dont giggle . QUEST	dont
doesnt the cat laugh ? QUEST	the cat doesnt laugh . QUEST	doesnt
dont my unicorns live ? QUEST	my unicorns dont live . QUEST	dont
doesnt some elephant giggle ? QUEST	some elephant doesnt giggle . QUEST	doesnt
do some monkeys live ? QUEST	some monkeys do live . QUEST	do
does the monkey read ? QUEST	the monkey does read . QUEST	does
does my yak giggle ? QUEST	my yak does giggle . QUEST	does
dont some unicorns giggle ? QUEST	some unicorns dont giggle . QUEST	dont
does some elephant giggle ? QUEST	some elephant does giggle . QUEST	does
doesnt some cat smile ? QUEST	some cat doesnt smile . QUEST	doesnt
does the cat live ? QUEST	the cat does live . QUEST	does
doesnt your unicorn live ? QUEST	your unicorn doesnt live . QUEST	doesnt
do your dogs smile ? QUEST	your dogs do smile . QUEST	do
dont her dogs smile ? QUEST	her dogs dont smile . QUEST	dont
do the monkeys laugh ? QUEST	the monkeys do laugh . QUEST	do
dont her cats giggle ? QUEST	her cats dont giggle . QUEST	dont
doesnt our unicorn read ? QUEST	our unicorn doesnt read . QUEST	doesnt
dont my yaks smile ? QUEST	my yaks dont smile . QUEST	dont
does some unicorn laugh ? QUEST	some unicorn does laugh . QUEST	does
doesnt some dog laugh ? QUEST	some dog doesnt laugh . QUEST	doesnt
doesnt my elephant live ? QUEST	my elephant doesnt live . QUEST	doesnt
doesnt her cat live ? QUEST	her cat doesnt live . QUEST	doesnt
do her birds laugh ? QUEST	her birds do laugh . QUEST	do
do my unicorns laugh ? QUEST	my unicorns do laugh . QUEST	do
does our bird giggle ? QUEST	our bird does giggle . QUEST	does
does her bird read ? QUEST	her bird does read . QUEST	does
dont her monkeys read ? QUEST	her monkeys dont read . QUEST	dont
does her seal smile ? QUEST	her seal does smile . QUEST	does
does her seal laugh ? QUEST	her seal does laugh . QUEST	does
do the cats sleep ? QUEST	the cats do sleep . QUEST	do
dont your cats laugh ? QUEST	your cats dont laugh . QUEST	dont
does her monkey sleep ? QUEST	her monkey does sleep . QUEST	does
do her rabbits smile ? QUEST	her rabbits do smile . QUEST	do
doesnt her rabbit smile ? QUEST	her rabbit doesnt smile . QUEST	doesnt
does her yak laugh ? QUEST	her yak does laugh . QUEST	does
doesnt her cat read ? QUEST	her cat doesnt read . QUEST	doesnt
doesnt the elephant read ? QUEST	the elephant doesnt read . QUEST	doesnt
doesnt your seal live ? QUEST	your seal doesnt live . QUEST	doesnt
do the monkeys live ? QUEST	the monkeys do live . QUEST	do
does her rabbit live ? QUEST	her rabbit does live . QUEST	does
dont her yaks read ? QUEST	her yaks dont read . QUEST	dont
does our monkey smile ? QUEST	our monkey does smile . QUEST	does
dont your cats giggle ? QUEST	your cats dont giggle . QUEST	dont
dont our birds smile ? QUEST	our birds dont smile . QUEST	dont
do her unicorns live ? QUEST	her unicorns do live . QUEST	do
do my elephants live ? QUEST	my elephants do live . QUEST	do
does some seal read ? QUEST	some seal does read . QUEST	does
doesnt my dog giggle ? QUEST	my dog doesnt giggle . QUEST	doesnt
does my dog giggle ? QUEST	my dog does giggle . QUEST	does
do my elephants sleep ? QUEST	my elephants do sleep . QUEST	do
dont her monkeys smile ? QUEST	her monkeys dont smile . QUEST	dont
do her seals laugh ? QUEST	her seals do laugh . QUEST	do
do my yaks read ? QUEST	my yaks do read . QUEST	do
dont my monkeys read ? QUEST	my monkeys dont read . QUEST	dont
do her dogs sleep ? QUEST	her dogs do sleep . QUEST	do
do my rabbits sleep ? QUEST	my rabbits do sleep . QUEST	do
does our dog sleep ? QUEST	our dog does sleep . QUEST	does
dont my unicorns live ? QUEST	my unicorns dont live . QUEST	dont
dont my rabbits live ? QUEST	my rabbits dont live . QUEST	dont
doesnt her rabbit read ? QUEST	her rabbit doesnt read . QUEST	doesnt
doesnt her unicorn sleep ? QUEST	her unicorn doesnt sleep . QUEST	doesnt
doesnt my cat sleep ? QUEST	my cat doesnt sleep . QUEST	doesnt
do your cats laugh ? QUEST	your cats do laugh . QUEST	do
does our bird sleep ? QUEST	our bird does sleep . QUEST	does
doesnt some rabbit laugh ? QUEST	some rabbit doesnt laugh . QUEST	doesnt
do your unicorns live ? QUEST	your unicorns do live . QUEST	do
do her cats live ? QUEST	her cats do live . QUEST	do
do our seals sleep ? QUEST	our seals do sleep . QUEST	do
dont my birds smile ? QUEST	my birds dont smile . QUEST	dont
dont my elephants read ? QUEST	my elephants dont read . QUEST	dont
do our yaks sleep ? QUEST	our yaks do sleep . QUEST	do
do some unicorns giggle ? QUEST	some unicorns do giggle . QUEST	do
dont some elephants sleep ? QUEST	some elephants dont sleep . QUEST	dont
doesnt some elephant read ? QUEST	some elephant doesnt read . QUEST	doesnt
does our rabbit laugh ? QUEST	our rabbit does laugh . QUEST	does
does our dog laugh ? QUEST	our dog does laugh . QUEST	does
do our cats live ? QUEST	our cats do live . QUEST	do
do the cats sleep ? QUEST	the cats do sleep . QUEST	do
dont my monkeys sleep ? QUEST	my monkeys dont sleep . QUEST	dont
dont the monkeys live ? QUEST	the monkeys dont live . QUEST	dont
doesnt our monkey smile ? QUEST	our monkey doesnt smile . QUEST	doesnt
does my rabbit laugh ? QUEST	my rabbit does laugh . QUEST	does
do her elephants live ? QUEST	her elephants do live . QUEST	do
dont some birds sleep ? QUEST	some birds dont sleep . QUEST	dont
do our seals live ? QUEST	our seals do live . QUEST	do
dont her dogs smile ? QUEST	her dogs dont smile . QUEST	dont
does my unicorn giggle ? QUEST	my unicorn does giggle . QUEST	does
dont some rabbits laugh ? QUEST	some rabbits dont laugh . QUEST	dont
doesnt her bird read ? QUEST	her bird doesnt read . QUEST	doesnt
do the elephants read ? QUEST	the elephants do read . QUEST	do
do my unicorns sleep ? QUEST	my unicorns do sleep . QUEST	do
does her monkey sleep ? QUEST	her monkey does sleep . QUEST	does
dont the yaks live ? QUEST	the yaks dont live . QUEST	dont
do our unicorns smile ? QUEST	our unicorns do smile . QUEST	do
dont our cats giggle ? QUEST	our cats dont giggle . QUEST	dont
do some dogs sleep ? QUEST	some dogs do sleep . QUEST	do
does my seal read ? QUEST	my seal does read . QUEST	does
doesnt some dog live ? QUEST	some dog doesnt live . QUEST	doesnt
doesnt our unicorn laugh ? QUEST	our unicorn doesnt laugh . QUEST	doesnt
do our yaks read ? QUEST	our yaks do read . QUEST	do
doesnt our elephant laugh ? QUEST	our elephant doesnt laugh . QUEST	doesnt
do our seals laugh ? QUEST	our seals do laugh . QUEST	do
do your dogs laugh ? QUEST	your dogs do laugh . QUEST	do
does her unicorn giggle ? QUEST	her unicorn does giggle . QUEST	does
does the dog smile ? QUEST	the dog does smile . QUEST	does
do our rabbits smile ? QUEST	our rabbits do smile . QUEST	do
dont your dogs sleep ? QUEST	your dogs dont sleep . QUEST	dont
do your cats smile ? QUEST	your cats do smile . QUEST	do
dont your rabbits smile ? QUEST	your rabbits dont smile . QUEST	dont
dont her seals giggle ? QUEST	her seals dont giggle . QUEST	dont
does our rabbit live ? QUEST	our rabbit does live . QUEST	does
doesnt some dog live ? QUEST	some dog doesnt live . QUEST	doesnt
do her dogs giggle ? QUEST	her dogs do giggle . QUEST	do
doesnt some dog read ? QUEST	some dog doesnt read . QUEST	doesnt
dont her dogs giggle ? QUEST	her dogs dont giggle . QUEST	dont
do the unicorns sleep ? QUEST	the unicorns do sleep . QUEST	do
do your elephants giggle ? QUEST	your elephants do giggle . QUEST	do
does our seal giggle ? QUEST	our seal does giggle . QUEST	does
does her bird live ? QUEST	her bird does live . QUEST	does
do my dogs laugh ? QUEST	my dogs do laugh . QUEST	do
doesnt your cat read ? QUEST	your cat doesnt read . QUEST	doesnt
does her dog smile ? QUEST	her dog does smile . QUEST	does
doesnt our rabbit read ? QUEST	our rabbit doesnt read . QUEST	doesnt
does my rabbit giggle ? QUEST	my rabbit does giggle . QUEST	does
doesnt your dog giggle ? QUEST	your dog doesnt giggle . QUEST	doesnt
doesnt our bird sleep ? QUEST	our bird doesnt sleep . QUEST	doesnt
dont our unicorns laugh ? QUEST	our unicorns dont laugh . QUEST	dont
doesnt some bird giggle ? QUEST	some bird doesnt giggle . QUEST	doesnt
does our rabbit laugh ? QUEST	our rabbit does laugh . QUEST	does
dont our unicorns giggle ? QUEST	our unicorns dont giggle . QUEST	dont
doesnt the dog smile ? QUEST	the dog doesnt smile . QUEST	doesnt
doesnt our yak live ? QUEST	our yak doesnt live . QUEST	doesnt
does her rabbit giggle ? QUEST	her rabbit does giggle . QUEST	does
does our seal laugh ? QUEST	our seal does laugh . QUEST	does
dont our yaks smile ? QUEST	our yaks dont smile . QUEST	dont
does my rabbit live ? QUEST	my rabbit does live . QUEST	does
dont my seals giggle ? QUEST	my seals dont giggle . QUEST	dont
doesnt our bird read ? QUEST	our bird doesnt read . QUEST	doesnt
doesnt my elephant read ? QUEST	my elephant doesnt read . QUEST	doesnt
do my yaks read ? QUEST	my yaks do read . QUEST	do
do my seals sleep ? QUEST	my seals do sleep . QUEST	do
do her dogs sleep ? QUEST	her dogs do sleep . QUEST	do
does the rabbit smile ? QUEST	the rabbit does smile . QUEST	does
does the unicorn sleep ? QUEST	the unicorn does sleep . QUEST	does
doesnt our bird live ? QUEST	our bird doesnt live . QUEST	doesnt
doesnt the rabbit smile ? QUEST	the rabbit doesnt smile . QUEST	doesnt
do my unicorns live ? QUEST	my unicorns do live . QUEST	do
do her birds live ? QUEST	her birds do live . QUEST	do
does the dog live ? QUEST	the dog does live . QUEST	does
dont her birds live ? QUEST	her birds dont live . QUEST	dont
doesnt her seal laugh ? QUEST	her seal doesnt laugh . QUEST	doesnt
does her seal laugh ? QUEST	her seal does laugh . QUEST	does
does our unicorn giggle ? QUEST	our unicorn does giggle . QUEST	does
does some dog read ? QUEST	some dog does read . QUEST	does
does her yak laugh ? QUEST	her yak does laugh . QUEST	does
does the unicorn laugh ? QUEST	the unicorn does laugh . QUEST	does
do her monkeys laugh ? QUEST	her monkeys do laugh . QUEST	do
dont my seals sleep ? QUEST	my seals dont sleep . QUEST	dont
dont your cats live ? QUEST	your cats dont live . QUEST	dont
does the dog read ? QUEST	the dog does read . QUEST	does
doesnt my monkey laugh ? QUEST	my monkey doesnt laugh . QUEST	doesnt
do our birds giggle ? QUEST	our birds do giggle . QUEST	do
does my dog smile ? QUEST	my dog does smile . QUEST	does
do our cats smile ? QUEST	our cats do smile . QUEST	do
dont our dogs smile ? QUEST	our dogs dont smile . QUEST	dont
does my yak laugh ? QUEST	my yak does laugh . QUEST	does
doesnt your rabbit read ? QUEST	your rabbit doesnt read . QUEST	doesnt
do the cats giggle ? QUEST	the cats do giggle . QUEST	do
dont my monkeys live ? QUEST	my monkeys dont live . QUEST	dont
do my elephants live ? QUEST	my elephants do live . QUEST	do
doesnt the dog live ? QUEST	the dog doesnt live . QUEST	doesnt
doesnt our unicorn smile ? QUEST	our unicorn doesnt smile . QUEST	doesnt
doesnt our elephant sleep ? QUEST	our elephant doesnt sleep . QUEST	doesnt
doesnt our unicorn sleep ? QUEST	our unicorn doesnt sleep . QUEST	doesnt
does our monkey live ? QUEST	our monkey does live . QUEST	does
does the dog read ? QUEST	the dog does read . QUEST	does
does our rabbit giggle ? QUEST	our rabbit does giggle . QUEST	does
does her dog giggle ? QUEST	her dog does giggle . QUEST	does
do the seals live ? QUEST	the seals do live . QUEST	do
do some unicorns read ? QUEST	some unicorns do read . QUEST	do
dont some yaks read ? QUEST	some yaks dont read . QUEST	dont
do your elephants read ? QUEST	your elephants do read . QUEST	do
does some dog sleep ? QUEST	some dog does sleep . QUEST	does
does my cat read ? QUEST	my cat does read . QUEST	does
does your bird laugh ? QUEST	your bird does laugh . QUEST	does
does your yak read ? QUEST	your yak does read . QUEST	does
dont her dogs sleep ? QUEST	her dogs dont sleep . QUEST	dont
does my yak live ? QUEST	my yak does live . QUEST	does
do the rabbits sleep ? QUEST	the rabbits do sleep . QUEST	do
do my cats read ? QUEST	my cats do read . QUEST	do
do her cats laugh ? QUEST	her cats do laugh . QUEST	do
does her bird live ? QUEST	her bird does live . QUEST	does
do your rabbits live ? QUEST	your rabbits do live . QUEST	do
do your unicorns read ? QUEST	your unicorns do read . QUEST	do
doesnt some bird live ? QUEST	some bird doesnt live . QUEST	doesnt
do some cats giggle ? QUEST	some cats do giggle . QUEST	do
dont my birds giggle ? QUEST	my birds dont giggle . QUEST	dont
doesnt some dog smile ? QUEST	some dog doesnt smile . QUEST	doesnt
does some elephant sleep ? QUEST	some elephant does sleep . QUEST	does
doesnt some seal smile ? QUEST	some seal doesnt smile . QUEST	doesnt
doesnt the yak giggle ? QUEST	the yak doesnt giggle . QUEST	doesnt
dont my elephants smile ? QUEST	my elephants dont smile . QUEST	dont
does the elephant live ? QUEST	the elephant does live . QUEST	does
do our cats sleep ? QUEST	our cats do sleep . QUEST	do
doesnt our rabbit sleep ? QUEST	our rabbit doesnt sleep . QUEST	doesnt
dont some birds live ? QUEST	some birds dont live . QUEST	dont
doesnt the dog sleep ? QUEST	the dog doesnt sleep . QUEST	doesnt
do some seals giggle ? QUEST	some seals do giggle . QUEST	do
doesnt the bird smile ? QUEST	the bird doesnt smile . QUEST	doesnt
does your unicorn sleep ? QUEST	your unicorn does sleep . QUEST	does
does my bird smile ? QUEST	my bird does smile . QUEST	does
does the elephant read ? QUEST	the elephant does read . QUEST	does
does some yak sleep ? QUEST	some yak does sleep . QUEST	does
does our rabbit laugh ? QUEST	our rabbit does laugh . QUEST	does
doesnt your dog read ? QUEST	your dog doesnt read . QUEST	doesnt
do your cats smile ? QUEST	your cats do smile . QUEST	do
doesnt your seal read ? QUEST	your seal doesnt read . QUEST	doesnt
do my cats laugh ? QUEST	my cats do laugh . QUEST	do
does our bird giggle ? QUEST	our bird does giggle . QUEST	does
does my cat laugh ? QUEST	my cat does laugh . QUEST	does
doesnt your unicorn laugh ? QUEST	your unicorn doesnt laugh . QUEST	doesnt
do our rabbits read ? QUEST	our rabbits do read . QUEST	do
dont your yaks live ? QUEST	your yaks dont live . QUEST	dont
doesnt your rabbit smile ? QUEST	your rabbit doesnt smile . QUEST	doesnt
doesnt your rabbit giggle ? QUEST	your rabbit doesnt giggle . QUEST	doesnt
dont my cats smile ? QUEST	my cats dont smile . QUEST	dont
dont our monkeys read ? QUEST	our monkeys dont read . QUEST	dont
doesnt the seal laugh ? QUEST	the seal doesnt laugh . QUEST	doesnt
do her seals giggle ? QUEST	her seals do giggle . QUEST	do
does my rabbit sleep ? QUEST	my rabbit does sleep . QUEST	does
do her seals live ? QUEST	her seals do live . QUEST	do
do my yaks sleep ? QUEST	my yaks do sleep . QUEST	do
does my rabbit smile ? QUEST	my rabbit does smile . QUEST	does
do my seals smile ? QUEST	my seals do smile . QUEST	do
dont your rabbits giggle ? QUEST	your rabbits dont giggle . QUEST	dont
doesnt our elephant laugh ? QUEST	our elephant doesnt laugh . QUEST	doesnt
do my rabbits read ? QUEST	my rabbits do read . QUEST	do
dont our yaks giggle ? QUEST	our yaks dont giggle . QUEST	dont
do my seals giggle ? QUEST	my seals do giggle . QUEST	do
dont my cats laugh ? QUEST	my cats dont laugh . QUEST	dont
doesnt the unicorn read ? QUEST	the unicorn doesnt read . QUEST	doesnt
do some dogs sleep ? QUEST	some dogs do sleep . QUEST	do
does the cat smile ? QUEST	the cat does smile . QUEST	does
do some dogs sleep ? QUEST	some dogs do sleep . QUEST	do
dont our birds sleep ? QUEST	our birds dont sleep . QUEST	dont
do her birds giggle ? QUEST	her birds do giggle . QUEST	do
doesnt my bird sleep ? QUEST	my bird doesnt sleep . QUEST	doesnt
do my birds sleep ? QUEST	my birds do sleep . QUEST	do
do her seals smile ? QUEST	her seals do smile . QUEST	do
does my rabbit sleep ? QUEST	my rabbit does sleep . QUEST	does
dont my birds live ? QUEST	my birds dont live . QUEST	dont
does your rabbit live ? QUEST	your rabbit does live . QUEST	does
do some yaks giggle ? QUEST	some yaks do giggle . QUEST	do
dont some monkeys live ? QUEST	some monkeys dont live . QUEST	dont
does your unicorn laugh ? QUEST	your unicorn does laugh . QUEST	does
dont your elephants sleep ? QUEST	your elephants dont sleep . QUEST	dont
doesnt some yak smile ? QUEST	some yak doesnt smile . QUEST	doesnt
doesnt your cat sleep ? QUEST	your cat doesnt sleep . QUEST	doesnt
does the unicorn smile ? QUEST	the unicorn does smile . QUEST	does
doesnt the rabbit giggle ? QUEST	the rabbit doesnt giggle . QUEST	doesnt
does the seal smile ? QUEST	the seal does smile . QUEST	does
does some elephant live ? QUEST	some elephant does live . QUEST	does
do some elephants smile ? QUEST	some elephants do smile . QUEST	do
does our monkey live ? QUEST	our monkey does live . QUEST	does
doesnt my unicorn live ? QUEST	my unicorn doesnt live . QUEST	doesnt
doesnt some unicorn sleep ? QUEST	some unicorn doesnt sleep . QUEST	doesnt
dont our monkeys smile ? QUEST	our monkeys dont smile . QUEST	dont
doesnt our unicorn live ? QUEST	our unicorn doesnt live . QUEST	doesnt
do our yaks live ? QUEST	our yaks do live . QUEST	do
dont our cats laugh ? QUEST	our cats dont laugh . QUEST	dont
do some birds laugh ? QUEST	some birds do laugh . QUEST	do
dont your seals read ? QUEST	your seals dont read . QUEST	dont
doesnt my bird live ? QUEST	my bird doesnt live . QUEST	doesnt
does the yak live ? QUEST	the yak does live . QUEST	does
do her birds live ? QUEST	her birds do live . QUEST	do
do our elephants laugh ? QUEST	our elephants do laugh . QUEST	do
doesnt her rabbit smile ? QUEST	her rabbit doesnt smile . QUEST	doesnt
do my dogs smile ? QUEST	my dogs do smile . QUEST	do
doesnt my yak sleep ? QUEST	my yak doesnt sleep . QUEST	doesnt
dont my yaks sleep ? QUEST	my yaks dont sleep . QUEST	dont
dont my monkeys live ? QUEST	my monkeys dont live . QUEST	dont
dont my monkeys live ? QUEST	my monkeys dont live . QUEST	dont
does your bird laugh ? QUEST	your bird does laugh . QUEST	does
dont her birds smile ? QUEST	her birds dont smile . QUEST	dont
does the unicorn giggle ? QUEST	the unicorn does giggle . QUEST	does
dont the cats live ? QUEST	the cats dont live . QUEST	dont
dont your yaks smile ? QUEST	your yaks dont smile . QUEST	dont
dont my elephants live ? QUEST	my elephants dont live . QUEST	dont
dont some dogs laugh ? QUEST	some dogs dont laugh . QUEST	dont
do some monkeys sleep ? QUEST	some monkeys do sleep . QUEST	do
does some bird read ? QUEST	some bird does read . QUEST	does
do your monkeys sleep ? QUEST	your monkeys do sleep . QUEST	do
doesnt your unicorn smile ? QUEST	your unicorn doesnt smile . QUEST	doesnt
doesnt her rabbit sleep ? QUEST	her rabbit doesnt sleep . QUEST	doesnt
do some rabbits smile ? QUEST	some rabbits do smile . QUEST	do
do the unicorns read ? QUEST	the unicorns do read . QUEST	do
does my dog read ? QUEST	my dog does read . QUEST	does
do our unicorns laugh ? QUEST	our unicorns do laugh . QUEST	do
dont your elephants sleep ? QUEST	your elephants dont sleep . QUEST	dont
does the rabbit read ? QUEST	the rabbit does read . QUEST	does
dont the elephants giggle ? QUEST	the elephants dont giggle . QUEST	dont
does some unicorn sleep ? QUEST	some unicorn does sleep . QUEST	does
do some dogs sleep ? QUEST	some dogs do sleep . QUEST	do
dont her cats laugh ? QUEST	her cats dont laugh . QUEST	dont
does her monkey laugh ? QUEST	her monkey does laugh . QUEST	does
do some yaks laugh ? QUEST	some yaks do laugh . QUEST	do
doesnt some monkey smile ? QUEST	some monkey doesnt smile . QUEST	doesnt
does your rabbit giggle ? QUEST	your rabbit does giggle . QUEST	does
doesnt the elephant sleep ? QUEST	the elephant doesnt sleep . QUEST	doesnt
dont the cats smile ? QUEST	the cats dont smile . QUEST	dont
dont our unicorns live ? QUEST	our unicorns dont live . QUEST	dont
do the monkeys giggle ? QUEST	the monkeys do giggle . QUEST	do
dont my unicorns read ? QUEST	my unicorns dont read . QUEST	dont
does your monkey laugh ? QUEST	your monkey does laugh . QUEST	does
doesnt my bird smile ? QUEST	my bird doesnt smile . QUEST	doesnt
dont my monkeys smile ? QUEST	my monkeys dont smile . QUEST	dont
dont your cats live ? QUEST	your cats dont live . QUEST	dont
doesnt our monkey giggle ? QUEST	our monkey doesnt giggle . QUEST	doesnt
does my seal read ? QUEST	my seal does read . QUEST	does
do your dogs laugh ? QUEST	your dogs do laugh . QUEST	do
does some rabbit read ? QUEST	some rabbit does read . QUEST	does
dont the birds laugh ? QUEST	the birds dont laugh . QUEST	dont
does her yak read ? QUEST	her yak does read . QUEST	does
dont our monkeys live ? QUEST	our monkeys dont live . QUEST	dont
do her rabbits giggle ? QUEST	her rabbits do giggle . QUEST	do
do her yaks read ? QUEST	her yaks do read . QUEST	do
does the seal read ? QUEST	the seal does read . QUEST	does
doesnt your yak smile ? QUEST	your yak doesnt smile . QUEST	doesnt
does some seal laugh ? QUEST	some seal does laugh . QUEST	does
dont our cats sleep ? QUEST	our cats dont sleep . QUEST	dont
doesnt our bird laugh ? QUEST	our bird doesnt laugh . QUEST	doesnt
does her elephant giggle ? QUEST	her elephant does giggle . QUEST	does
dont my dogs read ? QUEST	my dogs dont read . QUEST	dont
does some cat live ? QUEST	some cat does live . QUEST	does
do her elephants read ? QUEST	her elephants do read . QUEST	do
does your elephant read ? QUEST	your elephant does read . QUEST	does
does your seal laugh ? QUEST	your seal does laugh . QUEST	does
does her yak smile ? QUEST	her yak does smile . QUEST	does
doesnt her elephant read ? QUEST	her elephant doesnt read . QUEST	doesnt
does your cat live ? QUEST	your cat does live . QUEST	does
does my cat read ? QUEST	my cat does read . QUEST	does
do her yaks laugh ? QUEST	her yaks do laugh . QUEST	do
dont your monkeys read ? QUEST	your monkeys dont read . QUEST	dont
do our elephants giggle ? QUEST	our elephants do giggle . QUEST	do
does my elephant laugh ? QUEST	my elephant does laugh . QUEST	does
dont my yaks laugh ? QUEST	my yaks dont laugh . QUEST	dont
does the dog read ? QUEST	the dog does read . QUEST	does
does my cat sleep ? QUEST	my cat does sleep . QUEST	does
do my dogs smile ? QUEST	my dogs do smile . QUEST	do
dont some rabbits smile ? QUEST	some rabbits dont smile . QUEST	dont
doesnt your elephant live ? QUEST	your elephant doesnt live . QUEST	doesnt
do our dogs giggle ? QUEST	our dogs do giggle . QUEST	do
dont our dogs sleep ? QUEST	our dogs dont sleep . QUEST	dont
dont your birds smile ? QUEST	your birds dont smile . QUEST	dont
dont our unicorns sleep ? QUEST	our unicorns dont sleep . QUEST	dont
does some dog read ? QUEST	some dog does read . QUEST	does
do my unicorns live ? QUEST	my unicorns do live . QUEST	do
doesnt her cat sleep ? QUEST	her cat doesnt sleep . QUEST	doesnt
does some dog sleep ? QUEST	some dog does sleep . QUEST	does
does my monkey live ? QUEST	my monkey does live . QUEST	does
dont some monkeys laugh ? QUEST	some monkeys dont laugh . QUEST	dont
doesnt some cat read ? QUEST	some cat doesnt read . QUEST	doesnt
does my elephant read ? QUEST	my elephant does read . QUEST	does
doesnt some unicorn live ? QUEST	some unicorn doesnt live . QUEST	doesnt
dont the dogs laugh ? QUEST	the dogs dont laugh . QUEST	dont
dont the yaks read ? QUEST	the yaks dont read . QUEST	dont
does her dog live ? QUEST	her dog does live . QUEST	does
do her unicorns live ? QUEST	her unicorns do live . QUEST	do
doesnt my rabbit smile ? QUEST	my rabbit doesnt smile . QUEST	doesnt
does my unicorn read ? QUEST	my unicorn does read . QUEST	does
doesnt the yak sleep ? QUEST	the yak doesnt sleep . QUEST	doesnt
do our monkeys laugh ? QUEST	our monkeys do laugh . QUEST	do
doesnt your bird laugh ? QUEST	your bird doesnt laugh . QUEST	doesnt
do my seals live ? QUEST	my seals do live . QUEST	do
do my cats giggle ? QUEST	my cats do giggle . QUEST	do
doesnt your seal smile ? QUEST	your seal doesnt smile . QUEST	doesnt
does our seal smile ? QUEST	our seal does smile . QUEST	does
does our dog live ? QUEST	our dog does live . QUEST	does
dont my unicorns giggle ? QUEST	my unicorns dont giggle . QUEST	dont
doesnt my monkey sleep ? QUEST	my monkey doesnt sleep . QUEST	doesnt
does my dog live ? QUEST	my dog does live . QUEST	does
doesnt the rabbit live ? QUEST	the rabbit doesnt live . QUEST	doesnt
doesnt her elephant live ? QUEST	her elephant doesnt live . QUEST	doesnt
do her unicorns sleep ? QUEST	her unicorns do sleep . QUEST	do
doesnt my dog laugh ? QUEST	my dog doesnt laugh . QUEST	doesnt
does some monkey laugh ? QUEST	some monkey does laugh . QUEST	does
dont your seals laugh ? QUEST	your seals dont laugh . QUEST	dont
dont your seals sleep ? QUEST	your seals dont sleep . QUEST	dont
does our bird sleep ? QUEST	our bird does sleep . QUEST	does
dont our unicorns read ? QUEST	our unicorns dont read . QUEST	dont
do our monkeys giggle ? QUEST	our monkeys do giggle . QUEST	do
doesnt some dog smile ? QUEST	some dog doesnt smile . QUEST	doesnt
doesnt some seal laugh ? QUEST	some seal doesnt laugh . QUEST	doesnt
doesnt the bird read ? QUEST	the bird doesnt read . QUEST	doesnt
does the cat read ? QUEST	the cat does read . QUEST	does
dont the birds laugh ? QUEST	the birds dont laugh . QUEST	dont
do your cats laugh ? QUEST	your cats do laugh . QUEST	do
do some cats read ? QUEST	some cats do read . QUEST	do
dont her cats giggle ? QUEST	her cats dont giggle . QUEST	dont
do her rabbits giggle ? QUEST	her rabbits do giggle . QUEST	do
does the dog laugh ? QUEST	the dog does laugh . QUEST	does
does my yak smile ? QUEST	my yak does smile . QUEST	does
doesnt the yak laugh ? QUEST	the yak doesnt laugh . QUEST	doesnt
does my yak live ? QUEST	my yak does live . QUEST	does
does some cat sleep ? QUEST	some cat does sleep . QUEST	does
dont her elephants read ? QUEST	her elephants dont read . QUEST	dont
dont her yaks live ? QUEST	her yaks dont live . QUEST	dont
doesnt your seal giggle ? QUEST	your seal doesnt giggle . QUEST	doesnt
does our seal read ? QUEST	our seal does read . QUEST	does
does some monkey read ? QUEST	some monkey does read . QUEST	does
doesnt some dog sleep ? QUEST	some dog doesnt sleep . QUEST	doesnt
do my unicorns sleep ? QUEST	my unicorns do sleep . QUEST	do
does the seal read ? QUEST	the seal does read . QUEST	does
doesnt our elephant read ? QUEST	our elephant doesnt read . QUEST	doesnt
dont our yaks read ? QUEST	our yaks dont read . QUEST	dont
doesnt her dog giggle ? QUEST	her dog doesnt giggle . QUEST	doesnt
doesnt her dog live ? QUEST	her dog doesnt live . QUEST	doesnt
dont some seals smile ? QUEST	some seals dont smile . QUEST	dont
do our seals smile ? QUEST	our seals do smile . QUEST	do
does our elephant sleep ? QUEST	our elephant does sleep . QUEST	does
does some cat live ? QUEST	some cat does live . QUEST	does
do the cats smile ? QUEST	the cats do smile . QUEST	do
does some yak laugh ? QUEST	some yak does laugh . QUEST	does
doesnt some rabbit laugh ? QUEST	some rabbit doesnt laugh . QUEST	doesnt
do some seals read ? QUEST	some seals do read . QUEST	do
dont her seals read ? QUEST	her seals dont read . QUEST	dont
doesnt the dog read ? QUEST	the dog doesnt read . QUEST	doesnt
dont her yaks sleep ? QUEST	her yaks dont sleep . QUEST	dont
doesnt our seal read ? QUEST	our seal doesnt read . QUEST	doesnt
dont my monkeys read ? QUEST	my monkeys dont read . QUEST	dont
do my rabbits giggle ? QUEST	my rabbits do giggle . QUEST	do
dont some cats read ? QUEST	some cats dont read . QUEST	dont
doesnt my bird live ? QUEST	my bird doesnt live . QUEST	doesnt
doesnt my bird laugh ? QUEST	my bird doesnt laugh . QUEST	doesnt
do our seals laugh ? QUEST	our seals do laugh . QUEST	do
do our elephants read ? QUEST	our elephants do read . QUEST	do
does some elephant live ? QUEST	some elephant does live . QUEST	does
dont some birds giggle ? QUEST	some birds dont giggle . QUEST	dont
do your seals sleep ? QUEST	your seals do sleep . QUEST	do
does her rabbit smile ? QUEST	her rabbit does smile . QUEST	does
dont our dogs giggle ? QUEST	our dogs dont giggle . QUEST	dont
doesnt my seal giggle ? QUEST	my seal doesnt giggle . QUEST	doesnt
do our seals read ? QUEST	our seals do read . QUEST	do
doesnt our yak sleep ? QUEST	our yak doesnt sleep . QUEST	doesnt
does my dog smile ? QUEST	my dog does smile . QUEST	does
doesnt her unicorn laugh ? QUEST	her unicorn doesnt laugh . QUEST	doesnt
dont my elephants laugh ? QUEST	my elephants dont laugh . QUEST	dont
does my monkey laugh ? QUEST	my monkey does laugh . QUEST	does
do your rabbits read ? QUEST	your rabbits do read . QUEST	do
dont some monkeys smile ? QUEST	some monkeys dont smile . QUEST	dont
doesnt the monkey live ? QUEST	the monkey doesnt live . QUEST	doesnt
dont her birds giggle ? QUEST	her birds dont giggle . QUEST	dont
dont your birds smile ? QUEST	your birds dont smile . QUEST	dont
doesnt the dog live ? QUEST	the dog doesnt live . QUEST	doesnt
doesnt the cat smile ? QUEST	the cat doesnt smile . QUEST	doesnt
does the rabbit live ? QUEST	the rabbit does live . QUEST	does
does some dog live ? QUEST	some dog does live . QUEST	does
do the rabbits giggle ? QUEST	the rabbits do giggle . QUEST	do
do my seals smile ? QUEST	my seals do smile . QUEST	do
dont my seals smile ? QUEST	my seals dont smile . QUEST	dont
doesnt our cat giggle ? QUEST	our cat doesnt giggle . QUEST	doesnt
dont your rabbits live ? QUEST	your rabbits dont live . QUEST	dont
do our elephants live ? QUEST	our elephants do live . QUEST	do
does her monkey sleep ? QUEST	her monkey does sleep . QUEST	does
doesnt the dog laugh ? QUEST	the dog doesnt laugh . QUEST	doesnt
dont the seals live ? QUEST	the seals dont live . QUEST	dont
does the cat sleep ? QUEST	the cat does sleep . QUEST	does
do the yaks sleep ? QUEST	the yaks do sleep . QUEST	do
do the monkeys read ? QUEST	the monkeys do read . QUEST	do
does some elephant giggle ? QUEST	some elephant does giggle . QUEST	does
doesnt our dog smile ? QUEST	our dog doesnt smile . QUEST	doesnt
dont her monkeys smile ? QUEST	her monkeys dont smile . QUEST	dont
does some dog giggle ? QUEST	some dog does giggle . QUEST	does
doesnt some elephant read ? QUEST	some elephant doesnt read . QUEST	doesnt
dont some rabbits read ? QUEST	some rabbits dont read . QUEST	dont
does your cat read ? QUEST	your cat does read . QUEST	does
doesnt the elephant live ? QUEST	the elephant doesnt live . QUEST	doesnt
do her yaks sleep ? QUEST	her yaks do sleep . QUEST	do
does our bird laugh ? QUEST	our bird does laugh . QUEST	does
dont the monkeys smile ? QUEST	the monkeys dont smile . QUEST	dont
does some monkey live ? QUEST	some monkey does live . QUEST	does
dont her unicorns sleep ? QUEST	her unicorns dont sleep . QUEST	dont
dont the unicorns read ? QUEST	the unicorns dont read . QUEST	dont
doesnt your dog read ? QUEST	your dog doesnt read . QUEST	doesnt
do the unicorns sleep ? QUEST	the unicorns do sleep . QUEST	do
doesnt the dog live ? QUEST	the dog doesnt live . QUEST	doesnt
dont the cats smile ? QUEST	the cats dont smile . QUEST	dont
does my cat smile ? QUEST	my cat does smile . QUEST	does
doesnt the dog read ? QUEST	the dog doesnt read . QUEST	doesnt
do the elephants read ? QUEST	the elephants do read . QUEST	do
do some rabbits read ? QUEST	some rabbits do read . QUEST	do
doesnt some seal read ? QUEST	some seal doesnt read . QUEST	doesnt
dont some yaks read ? QUEST	some yaks dont read . QUEST	dont
does your seal live ? QUEST	your seal does live . QUEST	does
does her unicorn giggle ? QUEST	her unicorn does giggle . QUEST	does
does her monkey giggle ? QUEST	her monkey does giggle . QUEST	does
does some elephant smile ? QUEST	some elephant does smile . QUEST	does
do some monkeys giggle ? QUEST	some monkeys do giggle . QUEST	do
do the cats laugh ? QUEST	the cats do laugh . QUEST	do
do the rabbits laugh ? QUEST	the rabbits do laugh . QUEST	do
do the unicorns sleep ? QUEST	the unicorns do sleep . QUEST	do
