could our cat sleep	our cat could sleep QUEST	could
will our rabbit smile	our rabbit will smile QUEST	will
will our rabbit sleep	our rabbit will sleep QUEST	will
would my cats giggle	my cats would giggle QUEST	would
could some unicorns smile	some unicorns could smile QUEST	could
can her yak read	her yak can read QUEST	can
can my seals sleep	my seals can sleep QUEST	can
can our unicorns giggle	our unicorns can giggle QUEST	can
would my birds read	my birds would read QUEST	would
would my bird laugh	my bird would laugh QUEST	would
could some rabbits laugh	some rabbits could laugh QUEST	could
can my elephants read	my elephants can read QUEST	can
would the yak smile	the yak would smile QUEST	would
can her cat read	her cat can read QUEST	can
will some yaks laugh	some yaks will laugh QUEST	will
will the monkeys read	the monkeys will read QUEST	will
could some monkeys laugh	some monkeys could laugh QUEST	could
will the monkeys live	the monkeys will live QUEST	will
could her elephants laugh	her elephants could laugh QUEST	could
would some seals laugh	some seals would laugh QUEST	would
will some dog laugh	some dog will laugh QUEST	will
would our rabbit live	our rabbit would live QUEST	would
could her yaks giggle	her yaks could giggle QUEST	could
could some unicorns smile	some unicorns could smile QUEST	could
would the cat laugh	the cat would laugh QUEST	would
can her seal live	her seal can live QUEST	can
would the yaks sleep	the yaks would sleep QUEST	would
will my yaks smile	my yaks will smile QUEST	will
can our unicorn giggle	our unicorn can giggle QUEST	can
can our unicorn sleep	our unicorn can sleep QUEST	can
can our cat giggle	our cat can giggle QUEST	can
will some yaks laugh	some yaks will laugh QUEST	will
will some unicorn giggle	some unicorn will giggle QUEST	will
can my monkey smile	my monkey can smile QUEST	can
will your bird smile	your bird will smile QUEST	will
will our birds laugh	our birds will laugh QUEST	will
can the elephant smile	the elephant can smile QUEST	can
would your seal smile	your seal would smile QUEST	would
will your cats live	your cats will live QUEST	will
would our monkey read	our monkey would read QUEST	would
will your yaks smile	your yaks will smile QUEST	will
can our seals read	our seals can read QUEST	can
will the monkey laugh	the monkey will laugh QUEST	will
would my unicorn smile	my unicorn would smile QUEST	would
could our bird live	our bird could live QUEST	could
can some elephants smile	some elephants can smile QUEST	can
can our dog sleep	our dog can sleep QUEST	can
could your dog live	your dog could live QUEST	could
could some dogs giggle	some dogs could giggle QUEST	could
will my cat smile	my cat will smile QUEST	will
could the yaks sleep	the yaks could sleep QUEST	could
will my seals read	my seals will read QUEST	will
could my seals smile	my seals could smile QUEST	could
could some unicorns live	some unicorns could live QUEST	could
would our unicorn read	our unicorn would read QUEST	would
would her dog laugh	her dog would laugh QUEST	would
would your yak giggle	your yak would giggle QUEST	would
will our cat smile	our cat will smile QUEST	will
could the elephants giggle	the elephants could giggle QUEST	could
could some yaks read	some yaks could read QUEST	could
can her monkey live	her monkey can live QUEST	can
will some elephant sleep	some elephant will sleep QUEST	will
could the seals giggle	the seals could giggle QUEST	could
can our unicorns read	our unicorns can read QUEST	can
would my yaks smile	my yaks would smile QUEST	would
could her dogs giggle	her dogs could giggle QUEST	could
could her dog laugh	her dog could laugh QUEST	could
could the cat giggle	the cat could giggle QUEST	could
will her rabbit giggle	her rabbit will giggle QUEST	will
could some bird giggle	some bird could giggle QUEST	could
can your yaks laugh	your yaks can laugh QUEST	can
could our yaks sleep	our yaks could sleep QUEST	could
would our cats laugh	our cats would laugh QUEST	would
could the elephants laugh	the elephants could laugh QUEST	could
can some yaks giggle	some yaks can giggle QUEST	can
could some rabbit giggle	some rabbit could giggle QUEST	could
could our rabbit live	our rabbit could live QUEST	could
can our dog read	our dog can read QUEST	can
can your rabbit live	your rabbit can live QUEST	can
would your elephant sleep	your elephant would sleep QUEST	would
would my unicorns laugh	my unicorns would laugh QUEST	would
could my rabbit live	my rabbit could live QUEST	could
would the dog laugh	the dog would laugh QUEST	would
could our dog live	our dog could live QUEST	could
will her yaks live	her yaks will live QUEST	will
could our dog sleep	our dog could sleep QUEST	could
would your seals sleep	your seals would sleep QUEST	would
can some rabbit sleep	some rabbit can sleep QUEST	can
could our monkey live	our monkey could live QUEST	could
would our monkey laugh	our monkey would laugh QUEST	would
would your monkey laugh	your monkey would laugh QUEST	would
will her yaks live	her yaks will live QUEST	will
would our yaks smile	our yaks would smile QUEST	would
can my cats read	my cats can read QUEST	can
will some unicorn smile	some unicorn will smile QUEST	will
would some monkey giggle	some monkey would giggle QUEST	would
will your rabbits laugh	your rabbits will laugh QUEST	will
would her rabbits smile	her rabbits would smile QUEST	would
can your bird smile	your bird can smile QUEST	can
could some rabbits smile	some rabbits could smile QUEST	could
could our monkeys giggle	our monkeys could giggle QUEST	could
will her yaks laugh	her yaks will laugh QUEST	will
will the dogs smile	the dogs will smile QUEST	will
could her seals live	her seals could live QUEST	could
can the rabbit read	the rabbit can read QUEST	can
would our seal read	our seal would read QUEST	would
can some rabbit sleep	some rabbit can sleep QUEST	can
can her unicorn read	her unicorn can read QUEST	can
will her unicorn read	her unicorn will read QUEST	will
could her cat laugh	her cat could laugh QUEST	could
could your rabbits live	your rabbits could live QUEST	could
would her cats smile	her cats would smile QUEST	would
can our birds sleep	our birds can sleep QUEST	can
would her yak sleep	her yak would sleep QUEST	would
can the monkey live	the monkey can live QUEST	can
will my yaks live	my yaks will live QUEST	will
could our seals sleep	our seals could sleep QUEST	could
could my elephant laugh	my elephant could laugh QUEST	could
would your bird sleep	your bird would sleep QUEST	would
can my unicorns read	my unicorns can read QUEST	can
will my monkey giggle	my monkey will giggle QUEST	will
could her monkeys live	her monkeys could live QUEST	could
can her dogs laugh	her dogs can laugh QUEST	can
can her rabbit laugh	her rabbit can laugh QUEST	can
could your elephants sleep	your elephants could sleep QUEST	could
would your rabbit giggle	your rabbit would giggle QUEST	would
could my seal sleep	my seal could sleep QUEST	could
would the yak sleep	the yak would sleep QUEST	would
could my yak read	my yak could read QUEST	could
can your elephant giggle	your elephant can giggle QUEST	can
will our yaks smile	our yaks will smile QUEST	will
would the monkeys laugh	the monkeys would laugh QUEST	would
would my unicorn sleep	my unicorn would sleep QUEST	would
can her cats read	her cats can read QUEST	can
can our seal smile	our seal can smile QUEST	can
would your seals smile	your seals would smile QUEST	would
would some seal read	some seal would read QUEST	would
can my cats smile	my cats can smile QUEST	can
could your monkeys smile	your monkeys could smile QUEST	could
could the monkeys laugh	the monkeys could laugh QUEST	could
would the birds sleep	the birds would sleep QUEST	would
would the birds live	the birds would live QUEST	would
will our birds sleep	our birds will sleep QUEST	will
would some cat read	some cat would read QUEST	would
will the bird giggle	the bird will giggle QUEST	will
could her yaks laugh	her yaks could laugh QUEST	could
can my cats read	my cats can read QUEST	can
can the cat smile	the cat can smile QUEST	can
can some cats giggle	some cats can giggle QUEST	can
can my seals read	my seals can read QUEST	can
will the rabbits live	the rabbits will live QUEST	will
will my elephants sleep	my elephants will sleep QUEST	will
can some elephant sleep	some elephant can sleep QUEST	can
could our yak read	our yak could read QUEST	could
can her elephants laugh	her elephants can laugh QUEST	can
could our rabbit laugh	our rabbit could laugh QUEST	could
can our elephants live	our elephants can live QUEST	can
can your seals laugh	your seals can laugh QUEST	can
can the birds sleep	the birds can sleep QUEST	can
could my rabbit giggle	my rabbit could giggle QUEST	could
can some cat laugh	some cat can laugh QUEST	can
could our monkeys laugh	our monkeys could laugh QUEST	could
will her elephant sleep	her elephant will sleep QUEST	will
can the bird laugh	the bird can laugh QUEST	can
can the bird read	the bird can read QUEST	can
will her unicorn giggle	her unicorn will giggle QUEST	will
will my rabbit smile	my rabbit will smile QUEST	will
would her cat live	her cat would live QUEST	would
can the elephant sleep	the elephant can sleep QUEST	can
would my seal read	my seal would read QUEST	would
can her cats giggle	her cats can giggle QUEST	can
can my birds read	my birds can read QUEST	can
would the unicorns read	the unicorns would read QUEST	would
will her yak sleep	her yak will sleep QUEST	will
could my yaks smile	my yaks could smile QUEST	could
can some yak laugh	some yak can laugh QUEST	can
would my cats giggle	my cats would giggle QUEST	would
would our unicorn giggle	our unicorn would giggle QUEST	would
could our rabbit giggle	our rabbit could giggle QUEST	could
will my rabbits read	my rabbits will read QUEST	will
would her dog read	her dog would read QUEST	would
would some unicorn giggle	some unicorn would giggle QUEST	would
could some yak read	some yak could read QUEST	could
could our cat laugh	our cat could laugh QUEST	could
can your rabbit live	your rabbit can live QUEST	can
will her cats live	her cats will live QUEST	will
would some seal sleep	some seal would sleep QUEST	would
could some unicorns read	some unicorns could read QUEST	could
could our yaks read	our yaks could read QUEST	could
could some cats giggle	some cats could giggle QUEST	could
could the seals giggle	the seals could giggle QUEST	could
could your birds smile	your birds could smile QUEST	could
can the rabbits sleep	the rabbits can sleep QUEST	can
could her yaks laugh	her yaks could laugh QUEST	could
could my dog sleep	my dog could sleep QUEST	could
can the rabbits smile	the rabbits can smile QUEST	can
could some unicorns giggle	some unicorns could giggle QUEST	could
will my unicorns read	my unicorns will read QUEST	will
will our dogs smile	our dogs will smile QUEST	will
would the elephant smile	the elephant would smile QUEST	would
can the bird smile	the bird can smile QUEST	can
would our yak laugh	our yak would laugh QUEST	would
would our bird smile	our bird would smile QUEST	would
would our cat laugh	our cat would laugh QUEST	would
will my dog live	my dog will live QUEST	will
would some rabbits read	some rabbits would read QUEST	would
can her dog read	her dog can read QUEST	can
can some elephant smile	some elephant can smile QUEST	can
could our monkeys giggle	our monkeys could giggle QUEST	could
would her rabbit live	her rabbit would live QUEST	would
could her dogs laugh	her dogs could laugh QUEST	could
can her seals laugh	her seals can laugh QUEST	can
could my rabbits live	my rabbits could live QUEST	could
could my seals smile	my seals could smile QUEST	could
will her dog giggle	her dog will giggle QUEST	will
could my elephant read	my elephant could read QUEST	could
can her seal sleep	her seal can sleep QUEST	can
can our dog giggle	our dog can giggle QUEST	can
would our yak smile	our yak would smile QUEST	would
will your elephants live	your elephants will live QUEST	will
would our monkey sleep	our monkey would sleep QUEST	would
can our unicorns smile	our unicorns can smile QUEST	can
could my yak laugh	my yak could laugh QUEST	could
can some bird live	some bird can live QUEST	can
could some dogs laugh	some dogs could laugh QUEST	could
would some elephants giggle	some elephants would giggle QUEST	would
would your bird giggle	your bird would giggle QUEST	would
will your seals giggle	your seals will giggle QUEST	will
will some monkey laugh	some monkey will laugh QUEST	will
would your yaks read	your yaks would read QUEST	would
would our seal read	our seal would read QUEST	would
can our yaks read	our yaks can read QUEST	can
will your bird laugh	your bird will laugh QUEST	will
will some cats read	some cats will read QUEST	will
can your birds smile	your birds can smile QUEST	can
could the rabbits smile	the rabbits could smile QUEST	could
could our monkey live	our monkey could live QUEST	could
will your cat giggle	your cat will giggle QUEST	will
could some cat laugh	some cat could laugh QUEST	could
could some rabbits smile	some rabbits could smile QUEST	could
will our dogs sleep	our dogs will sleep QUEST	will
will our dogs read	our dogs will read QUEST	will
can my elephant sleep	my elephant can sleep QUEST	can
could my dog smile	my dog could smile QUEST	could
would our unicorn live	our unicorn would live QUEST	would
will her monkeys sleep	her monkeys will sleep QUEST	will
can the monkey live	the monkey can live QUEST	can
could my yak sleep	my yak could sleep QUEST	could
would her unicorn read	her unicorn would read QUEST	would
can her rabbit sleep	her rabbit can sleep QUEST	can
will her bird live	her bird will live QUEST	will
can some birds giggle	some birds can giggle QUEST	can
would the seal live	the seal would live QUEST	would
could the yak live	the yak could live QUEST	could
will my yaks read	my yaks will read QUEST	will
would my dogs sleep	my dogs would sleep QUEST	would
would our dogs sleep	our dogs would sleep QUEST	would
could some cats giggle	some cats could giggle QUEST	could
can some monkey sleep	some monkey can sleep QUEST	can
could my dog smile	my dog could smile QUEST	could
will the seals live	the seals will live QUEST	will
would her dog sleep	her dog would sleep QUEST	would
would the unicorns giggle	the unicorns would giggle QUEST	would
can my rabbits laugh	my rabbits can laugh QUEST	can
could the birds giggle	the birds could giggle QUEST	could
could our birds giggle	our birds could giggle QUEST	could
can your unicorns laugh	your unicorns can laugh QUEST	can
would my monkey read	my monkey would read QUEST	would
will some birds read	some birds will read QUEST	will
would her seal smile	her seal would smile QUEST	would
will our dog laugh	our dog will laugh QUEST	will
could the birds laugh	the birds could laugh QUEST	could
will our dogs giggle	our dogs will giggle QUEST	will
could some dog laugh	some dog could laugh QUEST	could
would our bird live	our bird would live QUEST	would
will her cat read	her cat will read QUEST	will
can her elephants giggle	her elephants can giggle QUEST	can
can your unicorns smile	your unicorns can smile QUEST	can
could your unicorns smile	your unicorns could smile QUEST	could
will her elephants smile	her elephants will smile QUEST	will
will her birds giggle	her birds will giggle QUEST	will
will your monkey smile	your monkey will smile QUEST	will
can our rabbit smile	our rabbit can smile QUEST	can
will some elephants laugh	some elephants will laugh QUEST	will
can your seal laugh	your seal can laugh QUEST	can
could your dog giggle	your dog could giggle QUEST	could
could the dog laugh	the dog could laugh QUEST	could
would some dog giggle	some dog would giggle QUEST	would
could some birds giggle	some birds could giggle QUEST	could
will your yaks smile	your yaks will smile QUEST	will
will your rabbits live	your rabbits will live QUEST	will
will your unicorn giggle	your unicorn will giggle QUEST	will
can our cats laugh	our cats can laugh QUEST	can
would our yak sleep	our yak would sleep QUEST	would
would some seal laugh	some seal would laugh QUEST	would
will our rabbit smile	our rabbit will smile QUEST	will
can our monkeys sleep	our monkeys can sleep QUEST	can
will our elephant smile	our elephant will smile QUEST	will
would her unicorns smile	her unicorns would smile QUEST	would
would the unicorns laugh	the unicorns would laugh QUEST	would
will our dogs live	our dogs will live QUEST	will
will some yak smile	some yak will smile QUEST	will
can some rabbits laugh	some rabbits can laugh QUEST	can
will the unicorns read	the unicorns will read QUEST	will
could some monkeys sleep	some monkeys could sleep QUEST	could
could her rabbit read	her rabbit could read QUEST	could
would the monkey laugh	the monkey would laugh QUEST	would
can her monkey sleep	her monkey can sleep QUEST	can
can my seals live	my seals can live QUEST	can
would my unicorns giggle	my unicorns would giggle QUEST	would
can her dogs sleep	her dogs can sleep QUEST	can
could my seals smile	my seals could smile QUEST	could
could the birds laugh	the birds could laugh QUEST	could
would the rabbit giggle	the rabbit would giggle QUEST	would
would your unicorns giggle	your unicorns would giggle QUEST	would
would some dog sleep	some dog would sleep QUEST	would
would the monkey read	the monkey would read QUEST	would
would her bird giggle	her bird would giggle QUEST	would
would the yak smile	the yak would smile QUEST	would
would our bird read	our bird would read QUEST	would
would my monkeys giggle	my monkeys would giggle QUEST	would
will our elephant laugh	our elephant will laugh QUEST	will
would my birds live	my birds would live QUEST	would
could our yaks live	our yaks could live QUEST	could
would her seals read	her seals would read QUEST	would
can the unicorns read	the unicorns can read QUEST	can
will her elephants sleep	her elephants will sleep QUEST	will
will my dog sleep	my dog will sleep QUEST	will
could some elephants live	some elephants could live QUEST	could
could the rabbits giggle	the rabbits could giggle QUEST	could
will your yak laugh	your yak will laugh QUEST	will
could her elephant read	her elephant could read QUEST	could
can our monkeys sleep	our monkeys can sleep QUEST	can
could some yaks smile	some yaks could smile QUEST	could
can our unicorns sleep	our unicorns can sleep QUEST	can
would her dogs laugh	her dogs would laugh QUEST	would
will the seals live	the seals will live QUEST	will
will some seal read	some seal will read QUEST	will
will your unicorn live	your unicorn will live QUEST	will
would the monkey read	the monkey would read QUEST	would
will our monkey smile	our monkey will smile QUEST	will
can my rabbits giggle	my rabbits can giggle QUEST	can
would my dog laugh	my dog would laugh QUEST	would
would your dog laugh	your dog would laugh QUEST	would
will the yak giggle	the yak will giggle QUEST	will
will the rabbits giggle	the rabbits will giggle QUEST	will
can her rabbits live	her rabbits can live QUEST	can
can your bird sleep	your bird can sleep QUEST	can
will my seals live	my seals will live QUEST	will
will my cat read	my cat will read QUEST	will
can some elephant sleep	some elephant can sleep QUEST	can
will the seal read	the seal will read QUEST	will
could her seals live	her seals could live QUEST	could
will my yaks read	my yaks will read QUEST	will
will some monkey read	some monkey will read QUEST	will
can some elephants read	some elephants can read QUEST	can
would some elephant laugh	some elephant would laugh QUEST	would
could your seals smile	your seals could smile QUEST	could
could your cats smile	your cats could smile QUEST	could
would her rabbit laugh	her rabbit would laugh QUEST	would
would your rabbit read	your rabbit would read QUEST	would
could my yak sleep	my yak could sleep QUEST	could
could the birds giggle	the birds could giggle QUEST	could
can the monkeys read	the monkeys can read QUEST	can
could the birds laugh	the birds could laugh QUEST	could
will my elephants smile	my elephants will smile QUEST	will
could the seals live	the seals could live QUEST	could
could my dog smile	my dog could smile QUEST	could
could the cats live	the cats could live QUEST	could
can the cat read	the cat can read QUEST	can
can her dog read	her dog can read QUEST	can
could our unicorns sleep	our unicorns could sleep QUEST	could
would your unicorns giggle	your unicorns would giggle QUEST	would
can your cat sleep	your cat can sleep QUEST	can
could your elephants giggle	your elephants could giggle QUEST	could
could my dogs sleep	my dogs could sleep QUEST	could
can her yaks read	her yaks can read QUEST	can
could your seals read	your seals could read QUEST	could
would the dogs giggle	the dogs would giggle QUEST	would
can the unicorn giggle	the unicorn can giggle QUEST	can
would the unicorn read	the unicorn would read QUEST	would
can your rabbit giggle	your rabbit can giggle QUEST	can
would her dog giggle	her dog would giggle QUEST	would
could our dogs live	our dogs could live QUEST	could
will her dog read	her dog will read QUEST	will
could our seal read	our seal could read QUEST	could
could her cats laugh	her cats could laugh QUEST	could
would some dogs live	some dogs would live QUEST	would
can the yak live	the yak can live QUEST	can
can some bird laugh	some bird can laugh QUEST	can
would her seal read	her seal would read QUEST	would
would your yak giggle	your yak would giggle QUEST	would
would the yak live	the yak would live QUEST	would
would the seals giggle	the seals would giggle QUEST	would
could your unicorn laugh	your unicorn could laugh QUEST	could
will my elephants smile	my elephants will smile QUEST	will
could our bird giggle	our bird could giggle QUEST	could
could her rabbit live	her rabbit could live QUEST	could
would my dog laugh	my dog would laugh QUEST	would
can my bird smile	my bird can smile QUEST	can
would some birds smile	some birds would smile QUEST	would
would her unicorns giggle	her unicorns would giggle QUEST	would
could our dogs sleep	our dogs could sleep QUEST	could
could her dogs sleep	her dogs could sleep QUEST	could
can some seal live	some seal can live QUEST	can
could her bird giggle	her bird could giggle QUEST	could
can your yak giggle	your yak can giggle QUEST	can
can your bird giggle	your bird can giggle QUEST	can
could her birds giggle	her birds could giggle QUEST	could
will our cat live	our cat will live QUEST	will
could some elephant read	some elephant could read QUEST	could
will some bird live	some bird will live QUEST	will
will some bird live	some bird will live QUEST	will
could our seal laugh	our seal could laugh QUEST	could
will my seals giggle	my seals will giggle QUEST	will
can my bird laugh	my bird can laugh QUEST	can
could our yak giggle	our yak could giggle QUEST	could
would her monkey live	her monkey would live QUEST	would
could my seal smile	my seal could smile QUEST	could
will my elephants live	my elephants will live QUEST	will
would our seal sleep	our seal would sleep QUEST	would
can her seals live	her seals can live QUEST	can
can my dogs giggle	my dogs can giggle QUEST	can
will the yak laugh	the yak will laugh QUEST	will
would your rabbits sleep	your rabbits would sleep QUEST	would
can some unicorns smile	some unicorns can smile QUEST	can
will my yak giggle	my yak will giggle QUEST	will
will my elephants read	my elephants will read QUEST	will
could your seals read	your seals could read QUEST	could
can your cat smile	your cat can smile QUEST	can
can your elephants sleep	your elephants can sleep QUEST	can
can some yaks laugh	some yaks can laugh QUEST	can
can some monkey laugh	some monkey can laugh QUEST	can
can your cats live	your cats can live QUEST	can
will your elephants smile	your elephants will smile QUEST	will
could your yaks giggle	your yaks could giggle QUEST	could
could her dog sleep	her dog could sleep QUEST	could
will her dogs live	her dogs will live QUEST	will
will her elephants live	her elephants will live QUEST	will
will your yaks read	your yaks will read QUEST	will
will our elephant sleep	our elephant will sleep QUEST	will
would your elephant sleep	your elephant would sleep QUEST	would
could my rabbit sleep	my rabbit could sleep QUEST	could
will my unicorn smile	my unicorn will smile QUEST	will
will the unicorns read	the unicorns will read QUEST	will
can the rabbits read	the rabbits can read QUEST	can
can the elephants read	the elephants can read QUEST	can
could your monkey sleep	your monkey could sleep QUEST	could
will the monkey laugh	the monkey will laugh QUEST	will
would our cats live	our cats would live QUEST	would
will the unicorns sleep	the unicorns will sleep QUEST	will
would the monkey giggle	the monkey would giggle QUEST	would
would her cat smile	her cat would smile QUEST	would
could her rabbits smile	her rabbits could smile QUEST	could
will her yaks giggle	her yaks will giggle QUEST	will
would some elephant laugh	some elephant would laugh QUEST	would
could your cat live	your cat could live QUEST	could
could your yaks smile	your yaks could smile QUEST	could
will my monkeys laugh	my monkeys will laugh QUEST	will
can our rabbit read	our rabbit can read QUEST	can
could your unicorn read	your unicorn could read QUEST	could
would your unicorns laugh	your unicorns would laugh QUEST	would
could our dogs smile	our dogs could smile QUEST	could
can her elephants giggle	her elephants can giggle QUEST	can
could the seal read	the seal could read QUEST	could
would some dog live	some dog would live QUEST	would
will the cat sleep	the cat will sleep QUEST	will
would our cats laugh	our cats would laugh QUEST	would
could the cats read	the cats could read QUEST	could
would the yak smile	the yak would smile QUEST	would
would her yak smile	her yak would smile QUEST	would
can her monkeys laugh	her monkeys can laugh QUEST	can
can some cat read	some cat can read QUEST	can
would some unicorns laugh	some unicorns would laugh QUEST	would
can my yaks live	my yaks can live QUEST	can
would my cat giggle	my cat would giggle QUEST	would
can the birds sleep	the birds can sleep QUEST	can
will the birds live	the birds will live QUEST	will
will our birds laugh	our birds will laugh QUEST	will
will the seals smile	the seals will smile QUEST	will
will the yaks live	the yaks will live QUEST	will
can your rabbits live	your rabbits can live QUEST	can
would her cat laugh	her cat would laugh QUEST	would
could your elephants smile	your elephants could smile QUEST	could
can some unicorns sleep	some unicorns can sleep QUEST	can
could our rabbits read	our rabbits could read QUEST	could
can our yaks laugh	our yaks can laugh QUEST	can
would the elephant laugh	the elephant would laugh QUEST	would
will my rabbit read	my rabbit will read QUEST	will
would my monkey sleep	my monkey would sleep QUEST	would
will her dogs giggle	her dogs will giggle QUEST	will
could your cat live	your cat could live QUEST	could
can some monkeys laugh	some monkeys can laugh QUEST	can
will her yaks live	her yaks will live QUEST	will
would some seal live	some seal would live QUEST	would
would our seals sleep	our seals would sleep QUEST	would
would your cats giggle	your cats would giggle QUEST	would
will the dog read	the dog will read QUEST	will
will some cats live	some cats will live QUEST	will
can our cats live	our cats can live QUEST	can
would my rabbits live	my rabbits would live QUEST	would
would your rabbit laugh	your rabbit would laugh QUEST	would
can your cat laugh	your cat can laugh QUEST	can
will some unicorn live	some unicorn will live QUEST	will
would her birds live	her birds would live QUEST	would
can my monkeys laugh	my monkeys can laugh QUEST	can
will her seal live	her seal will live QUEST	will
can some seal smile	some seal can smile QUEST	can
could my cat live	my cat could live QUEST	could
would the monkeys live	the monkeys would live QUEST	would
would our seal smile	our seal would smile QUEST	would
would some seal laugh	some seal would laugh QUEST	would
could your monkey giggle	your monkey could giggle QUEST	could
can her monkey read	her monkey can read QUEST	can
will my seal live	my seal will live QUEST	will
can our rabbit smile	our rabbit can smile QUEST	can
could your dogs giggle	your dogs could giggle QUEST	could
can your monkeys giggle	your monkeys can giggle QUEST	can
would my birds giggle	my birds would giggle QUEST	would
could the yaks giggle	the yaks could giggle QUEST	could
could my seal smile	my seal could smile QUEST	could
will my elephant read	my elephant will read QUEST	will
will your seal giggle	your seal will giggle QUEST	will
could some cat giggle	some cat could giggle QUEST	could
would the cats read	the cats would read QUEST	would
can our rabbits giggle	our rabbits can giggle QUEST	can
can my bird sleep	my bird can sleep QUEST	can
can your cat smile	your cat can smile QUEST	can
could her seals read	her seals could read QUEST	could
could the cats live	the cats could live QUEST	could
will some rabbits smile	some rabbits will smile QUEST	will
could your bird read	your bird could read QUEST	could
can some dogs sleep	some dogs can sleep QUEST	can
can some unicorn live	some unicorn can live QUEST	can
will the yak giggle	the yak will giggle QUEST	will
can my seals live	my seals can live QUEST	can
can my rabbits giggle	my rabbits can giggle QUEST	can
would our birds read	our birds would read QUEST	would
would our yak live	our yak would live QUEST	would
could my birds laugh	my birds could laugh QUEST	could
can my unicorns giggle	my unicorns can giggle QUEST	can
can the dogs smile	the dogs can smile QUEST	can
could our unicorns live	our unicorns could live QUEST	could
could our elephants read	our elephants could read QUEST	could
could her bird read	her bird could read QUEST	could
can her dog live	her dog can live QUEST	can
will some birds live	some birds will live QUEST	will
would our seals live	our seals would live QUEST	would
can her dogs laugh	her dogs can laugh QUEST	can
can her elephant laugh	her elephant can laugh QUEST	can
would my unicorn laugh	my unicorn would laugh QUEST	would
could the dog sleep	the dog could sleep QUEST	could
can her bird read	her bird can read QUEST	can
could the unicorn smile	the unicorn could smile QUEST	could
will the monkeys smile	the monkeys will smile QUEST	will
will our elephants read	our elephants will read QUEST	will
could my cat live	my cat could live QUEST	could
will my elephant live	my elephant will live QUEST	will
could her seals sleep	her seals could sleep QUEST	could
could our cats smile	our cats could smile QUEST	could
will her rabbit smile	her rabbit will smile QUEST	will
could her seal sleep	her seal could sleep QUEST	could
could some monkeys sleep	some monkeys could sleep QUEST	could
would the yaks sleep	the yaks would sleep QUEST	would
will the cats laugh	the cats will laugh QUEST	will
would my unicorns live	my unicorns would live QUEST	would
could our seal giggle	our seal could giggle QUEST	could
could my seal giggle	my seal could giggle QUEST	could
will our elephants giggle	our elephants will giggle QUEST	will
can the monkeys smile	the monkeys can smile QUEST	can
will my yak live	my yak will live QUEST	will
would our elephants sleep	our elephants would sleep QUEST	would
can her rabbit smile	her rabbit can smile QUEST	can
will our rabbits live	our rabbits will live QUEST	will
will your elephants read	your elephants will read QUEST	will
will her yaks giggle	her yaks will giggle QUEST	will
would our unicorns smile	our unicorns would smile QUEST	would
will my monkeys sleep	my monkeys will sleep QUEST	will
can the yaks read	the yaks can read QUEST	can
would your unicorns sleep	your unicorns would sleep QUEST	would
could my rabbits laugh	my rabbits could laugh QUEST	could
would her seal sleep	her seal would sleep QUEST	would
could her cat giggle	her cat could giggle QUEST	could
will your elephant laugh	your elephant will laugh QUEST	will
will my seals read	my seals will read QUEST	will
will her elephants live	her elephants will live QUEST	will
would the rabbit laugh	the rabbit would laugh QUEST	would
can our birds smile	our birds can smile QUEST	can
would your dogs smile	your dogs would smile QUEST	would
can her unicorns live	her unicorns can live QUEST	can
could some monkey live	some monkey could live QUEST	could
would the elephants giggle	the elephants would giggle QUEST	would
will her seal giggle	her seal will giggle QUEST	will
will some dogs giggle	some dogs will giggle QUEST	will
would her rabbit laugh	her rabbit would laugh QUEST	would
will your elephants giggle	your elephants will giggle QUEST	will
will your yaks giggle	your yaks will giggle QUEST	will
would her elephant giggle	her elephant would giggle QUEST	would
will some elephants giggle	some elephants will giggle QUEST	will
could her birds smile	her birds could smile QUEST	could
would some dog giggle	some dog would giggle QUEST	would
could her elephants laugh	her elephants could laugh QUEST	could
would my rabbits smile	my rabbits would smile QUEST	would
would some dog smile	some dog would smile QUEST	would
would my yak sleep	my yak would sleep QUEST	would
can your yaks sleep	your yaks can sleep QUEST	can
could your cat read	your cat could read QUEST	could
can the unicorns read	the unicorns can read QUEST	can
would her yak laugh	her yak would laugh QUEST	would
would my monkey smile	my monkey would smile QUEST	would
could your unicorns live	your unicorns could live QUEST	could
will the unicorn read	the unicorn will read QUEST	will
will her yak sleep	her yak will sleep QUEST	will
will my elephants smile	my elephants will smile QUEST	will
could our birds sleep	our birds could sleep QUEST	could
could some monkeys live	some monkeys could live QUEST	could
would your dogs smile	your dogs would smile QUEST	would
can some seals sleep	some seals can sleep QUEST	can
will my birds read	my birds will read QUEST	will
could your seals read	your seals could read QUEST	could
will our seals live	our seals will live QUEST	will
can some monkeys read	some monkeys can read QUEST	can
can your rabbit giggle	your rabbit can giggle QUEST	can
could her unicorns live	her unicorns could live QUEST	could
could our yak laugh	our yak could laugh QUEST	could
can my rabbit read	my rabbit can read QUEST	can
can your dogs giggle	your dogs can giggle QUEST	can
can her unicorns live	her unicorns can live QUEST	can
can her seals live	her seals can live QUEST	can
will the monkeys laugh	the monkeys will laugh QUEST	will
would our unicorns giggle	our unicorns would giggle QUEST	would
would the cat giggle	the cat would giggle QUEST	would
would some monkey live	some monkey would live QUEST	would
will her cat read	her cat will read QUEST	will
could her birds read	her birds could read QUEST	could
could my cats smile	my cats could smile QUEST	could
would some yaks smile	some yaks would smile QUEST	would
can your unicorns read	your unicorns can read QUEST	can
will her dogs laugh	her dogs will laugh QUEST	will
would your seals smile	your seals would smile QUEST	would
would our dogs live	our dogs would live QUEST	would
could your cat live	your cat could live QUEST	could
can her seals read	her seals can read QUEST	can
can some seal live	some seal can live QUEST	can
can our monkey sleep	our monkey can sleep QUEST	can
would some monkeys giggle	some monkeys would giggle QUEST	would
can her yaks giggle	her yaks can giggle QUEST	can
will the monkey live	the monkey will live QUEST	will
can my unicorns giggle	my unicorns can giggle QUEST	can
could your bird smile	your bird could smile QUEST	could
would some yaks live	some yaks would live QUEST	would
would my dogs laugh	my dogs would laugh QUEST	would
would our bird smile	our bird would smile QUEST	would
will our yaks laugh	our yaks will laugh QUEST	will
will your yak smile	your yak will smile QUEST	will
will my yaks laugh	my yaks will laugh QUEST	will
will my elephant laugh	my elephant will laugh QUEST	will
would her monkeys read	her monkeys would read QUEST	would
can some elephants live	some elephants can live QUEST	can
could my cats laugh	my cats could laugh QUEST	could
could your dog giggle	your dog could giggle QUEST	could
will your cats live	your cats will live QUEST	will
will the dog laugh	the dog will laugh QUEST	will
will some elephant sleep	some elephant will sleep QUEST	will
will our elephant laugh	our elephant will laugh QUEST	will
can her unicorn sleep	her unicorn can sleep QUEST	can
would the elephant laugh	the elephant would laugh QUEST	would
could your bird laugh	your bird could laugh QUEST	could
will some rabbit giggle	some rabbit will giggle QUEST	will
can some yak laugh	some yak can laugh QUEST	can
would her elephant live	her elephant would live QUEST	would
would the rabbit laugh	the rabbit would laugh QUEST	would
could the bird sleep	the bird could sleep QUEST	could
will our yaks live	our yaks will live QUEST	will
will your monkeys smile	your monkeys will smile QUEST	will
can the unicorns laugh	the unicorns can laugh QUEST	can
can your elephant giggle	your elephant can giggle QUEST	can
could her cats sleep	her cats could sleep QUEST	could
would our birds read	our birds would read QUEST	would
would my bird live	my bird would live QUEST	would
could the yak read	the yak could read QUEST	could
could my monkey sleep	my monkey could sleep QUEST	could
can our birds read	our birds can read QUEST	can
would her bird smile	her bird would smile QUEST	would
could my elephant smile	my elephant could smile QUEST	could
can my elephants read	my elephants can read QUEST	can
could our bird live	our bird could live QUEST	could
can your rabbit giggle	your rabbit can giggle QUEST	can
can her dogs giggle	her dogs can giggle QUEST	can
would your unicorn smile	your unicorn would smile QUEST	would
could my yaks smile	my yaks could smile QUEST	could
will some monkeys read	some monkeys will read QUEST	will
will my monkeys read	my monkeys will read QUEST	will
can the elephant read	the elephant can read QUEST	can
could the cat laugh	the cat could laugh QUEST	could
would my bird live	my bird would live QUEST	would
can my unicorn sleep	my unicorn can sleep QUEST	can
will some elephant live	some elephant will live QUEST	will
would my cats giggle	my cats would giggle QUEST	would
could your cats sleep	your cats could sleep QUEST	could
would her monkeys sleep	her monkeys would sleep QUEST	would
will some unicorn sleep	some unicorn will sleep QUEST	will
would my unicorns sleep	my unicorns would sleep QUEST	would
can my cat live	my cat can live QUEST	can
would her unicorns laugh	her unicorns would laugh QUEST	would
can my seals live	my seals can live QUEST	can
could her rabbits smile	her rabbits could smile QUEST	could
can her dog read	her dog can read QUEST	can
could our cat live	our cat could live QUEST	could
could our seal read	our seal could read QUEST	could
could some monkey smile	some monkey could smile QUEST	could
could the seal smile	the seal could smile QUEST	could
can your monkeys live	your monkeys can live QUEST	can
can your monkey sleep	your monkey can sleep QUEST	can
could our cat read	our cat could read QUEST	could
could her rabbits live	her rabbits could live QUEST	could
could some cat smile	some cat could smile QUEST	could
will your unicorns laugh	your unicorns will laugh QUEST	will
can our cats giggle	our cats can giggle QUEST	can
would some rabbit sleep	some rabbit would sleep QUEST	would
will her unicorn sleep	her unicorn will sleep QUEST	will
will some unicorns read	some unicorns will read QUEST	will
could some seal laugh	some seal could laugh QUEST	could
will the dogs read	the dogs will read QUEST	will
can my yak smile	my yak can smile QUEST	can
would some seal read	some seal would read QUEST	would
will my elephants sleep	my elephants will sleep QUEST	will
will some elephants sleep	some elephants will sleep QUEST	will
would my birds smile	my birds would smile QUEST	would
would the dog giggle	the dog would giggle QUEST	would
could our dogs live	our dogs could live QUEST	could
would my yak giggle	my yak would giggle QUEST	would
could some elephants sleep	some elephants could sleep QUEST	could
could some elephants laugh	some elephants could laugh QUEST	could
would our cat smile	our cat would smile QUEST	would
can the elephants laugh	the elephants can laugh QUEST	can
will my dogs giggle	my dogs will giggle QUEST	will
could her rabbits read	her rabbits could read QUEST	could
could my seals smile	my seals could smile QUEST	could
will my unicorn read	my unicorn will read QUEST	will
can my unicorns read	my unicorns can read QUEST	can
could your monkeys laugh	your monkeys could laugh QUEST	could
can the seals smile	the seals can smile QUEST	can
could the cats giggle	the cats could giggle QUEST	could
will some yak live	some yak will live QUEST	will
could some birds live	some birds could live QUEST	could
could our unicorn giggle	our unicorn could giggle QUEST	could
would the rabbit read	the rabbit would read QUEST	would
will my monkeys read	my monkeys will read QUEST	will
will some elephants sleep	some elephants will sleep QUEST	will
can your unicorns laugh	your unicorns can laugh QUEST	can
will the yak read	the yak will read QUEST	will
can our dog smile	our dog can smile QUEST	can
could the unicorn laugh	the unicorn could laugh QUEST	could
would some elephants read	some elephants would read QUEST	would
will some yak live	some yak will live QUEST	will
would our yak read	our yak would read QUEST	would
would our seals laugh	our seals would laugh QUEST	would
will my cat sleep	my cat will sleep QUEST	will
can some yaks read	some yaks can read QUEST	can
can our birds smile	our birds can smile QUEST	can
can her unicorn giggle	her unicorn can giggle QUEST	can
will some monkey read	some monkey will read QUEST	will
will the bird smile	the bird will smile QUEST	will
could her rabbit live	her rabbit could live QUEST	could
will my seal live	my seal will live QUEST	will
will your elephants sleep	your elephants will sleep QUEST	will
could her dogs sleep	her dogs could sleep QUEST	could
will my elephants giggle	my elephants will giggle QUEST	will
could your rabbit giggle	your rabbit could giggle QUEST	could
can our elephant read	our elephant can read QUEST	can
could our cat giggle	our cat could giggle QUEST	could
will some rabbits read	some rabbits will read QUEST	will
can the cats giggle	the cats can giggle QUEST	can
will your rabbit live	your rabbit will live QUEST	will
would her dog sleep	her dog would sleep QUEST	would
can the yaks giggle	the yaks can giggle QUEST	can
can our unicorn live	our unicorn can live QUEST	can
can your seals giggle	your seals can giggle QUEST	can
will your birds live	your birds will live QUEST	will
would the rabbits giggle	the rabbits would giggle QUEST	would
can our unicorns laugh	our unicorns can laugh QUEST	can
would our elephants giggle	our elephants would giggle QUEST	would
will her cats read	her cats will read QUEST	will
could her birds live	her birds could live QUEST	could
would my unicorn live	my unicorn would live QUEST	would
will her seal sleep	her seal will sleep QUEST	will
would her seal sleep	her seal would sleep QUEST	would
could our yaks laugh	our yaks could laugh QUEST	could
could some rabbit read	some rabbit could read QUEST	could
will your birds laugh	your birds will laugh QUEST	will
will your rabbits smile	your rabbits will smile QUEST	will
can your yaks giggle	your yaks can giggle QUEST	can
would our rabbits smile	our rabbits would smile QUEST	would
would some seal live	some seal would live QUEST	would
can the rabbit sleep	the rabbit can sleep QUEST	can
will our dog giggle	our dog will giggle QUEST	will
would her seals laugh	her seals would laugh QUEST	would
would my dogs sleep	my dogs would sleep QUEST	would
can your cats laugh	your cats can laugh QUEST	can
can her rabbit smile	her rabbit can smile QUEST	can
would your monkey giggle	your monkey would giggle QUEST	would
would some cats giggle	some cats would giggle QUEST	would
could my birds giggle	my birds could giggle QUEST	could
can my unicorns giggle	my unicorns can giggle QUEST	can
can our unicorn read	our unicorn can read QUEST	can
can our unicorn smile	our unicorn can smile QUEST	can
can our rabbit read	our rabbit can read QUEST	can
will my seals read	my seals will read QUEST	will
would her monkey read	her monkey would read QUEST	would
will my birds read	my birds will read QUEST	will
will the elephants sleep	the elephants will sleep QUEST	will
can some elephant laugh	some elephant can laugh QUEST	can
can some cats laugh	some cats can laugh QUEST	can
can our elephant giggle	our elephant can giggle QUEST	can
will your yaks laugh	your yaks will laugh QUEST	will
can my yak laugh	my yak can laugh QUEST	can
can my seal sleep	my seal can sleep QUEST	can
would my seal sleep	my seal would sleep QUEST	would
can our yaks smile	our yaks can smile QUEST	can
can my bird live	my bird can live QUEST	can
could the monkeys live	the monkeys could live QUEST	could
could her rabbits read	her rabbits could read QUEST	could
can my seals read	my seals can read QUEST	can
would the bird sleep	the bird would sleep QUEST	would
could my monkeys giggle	my monkeys could giggle QUEST	could
could the bird sleep	the bird could sleep QUEST	could
can our cats live	our cats can live QUEST	can
will my rabbit live	my rabbit will live QUEST	will
would my birds giggle	my birds would giggle QUEST	would
would her dog live	her dog would live QUEST	would
could my elephant smile	my elephant could smile QUEST	could
could your elephant read	your elephant could read QUEST	could
could the monkeys smile	the monkeys could smile QUEST	could
would my seal live	my seal would live QUEST	would
would our unicorns laugh	our unicorns would laugh QUEST	would
would our rabbits giggle	our rabbits would giggle QUEST	would
will her cats sleep	her cats will sleep QUEST	will
would our elephant sleep	our elephant would sleep QUEST	would
could the cats live	the cats could live QUEST	could
could the dogs laugh	the dogs could laugh QUEST	could
could some yak giggle	some yak could giggle QUEST	could
could the birds sleep	the birds could sleep QUEST	could
can your monkeys smile	your monkeys can smile QUEST	can
could the elephant smile	the elephant could smile QUEST	could
can our cats smile	our cats can smile QUEST	can
could some unicorns sleep	some unicorns could sleep QUEST	could
can our unicorn sleep	our unicorn can sleep QUEST	can
could some elephant giggle	some elephant could giggle QUEST	could
can her unicorn smile	her unicorn can smile QUEST	can
could my bird live	my bird could live QUEST	could
could my unicorns laugh	my unicorns could laugh QUEST	could
will some seal sleep	some seal will sleep QUEST	will
can her dogs laugh	her dogs can laugh QUEST	can
could some yaks read	some yaks could read QUEST	could
can the bird read	the bird can read QUEST	can
would our elephant giggle	our elephant would giggle QUEST	would
can the seals live	the seals can live QUEST	can
could her yaks read	her yaks could read QUEST	could
would my seal giggle	my seal would giggle QUEST	would
will some birds live	some birds will live QUEST	will
could some birds live	some birds could live QUEST	could
will her dog smile	her dog will smile QUEST	will
would our bird read	our bird would read QUEST	would
can my seals giggle	my seals can giggle QUEST	can
would my seals smile	my seals would smile QUEST	would
can the cat laugh	the cat can laugh QUEST	can
could some bird live	some bird could live QUEST	could
would your unicorns live	your unicorns would live QUEST	would
would my seal giggle	my seal would giggle QUEST	would
could some unicorns sleep	some unicorns could sleep QUEST	could
can some seal smile	some seal can smile QUEST	can
could our yak giggle	our yak could giggle QUEST	could
can the cat read	the cat can read QUEST	can
will some unicorns sleep	some unicorns will sleep QUEST	will
will our seals sleep	our seals will sleep QUEST	will
would your yaks sleep	your yaks would sleep QUEST	would
will my cats read	my cats will read QUEST	will
could her birds read	her birds could read QUEST	could
could her birds giggle	her birds could giggle QUEST	could
will the dog sleep	the dog will sleep QUEST	will
will the rabbit sleep	the rabbit will sleep QUEST	will
could my elephants read	my elephants could read QUEST	could
would your unicorn read	your unicorn would read QUEST	would
would my elephant live	my elephant would live QUEST	would
could some elephant read	some elephant could read QUEST	could
could your elephant read	your elephant could read QUEST	could
will her seals read	her seals will read QUEST	will
could her cat smile	her cat could smile QUEST	could
can some seal read	some seal can read QUEST	can
will her dog laugh	her dog will laugh QUEST	will
will the rabbit smile	the rabbit will smile QUEST	will
can some cats live	some cats can live QUEST	can
will some unicorns sleep	some unicorns will sleep QUEST	will
can her cat smile	her cat can smile QUEST	can
would some cats read	some cats would read QUEST	would
can your bird sleep	your bird can sleep QUEST	can
could my rabbits sleep	my rabbits could sleep QUEST	could
can my yak laugh	my yak can laugh QUEST	can
will the rabbit read	the rabbit will read QUEST	will
will the unicorn laugh	the unicorn will laugh QUEST	will
would her bird laugh	her bird would laugh QUEST	would
can our unicorn read	our unicorn can read QUEST	can
can the cat laugh	the cat can laugh QUEST	can
can your elephant live	your elephant can live QUEST	can
can your elephant laugh	your elephant can laugh QUEST	can
would her birds smile	her birds would smile QUEST	would
could my dog live	my dog could live QUEST	could
would some seal laugh	some seal would laugh QUEST	would
can her cats sleep	her cats can sleep QUEST	can
can our rabbit smile	our rabbit can smile QUEST	can
can her dogs live	her dogs can live QUEST	can
will my elephants giggle	my elephants will giggle QUEST	will
could her cat read	her cat could read QUEST	could
would some elephant live	some elephant would live QUEST	would
would her elephants smile	her elephants would smile QUEST	would
can the monkey smile	the monkey can smile QUEST	can
could some elephant sleep	some elephant could sleep QUEST	could
can some seal sleep	some seal can sleep QUEST	can
would some seal giggle	some seal would giggle QUEST	would
can her cat laugh	her cat can laugh QUEST	can
could your yaks laugh	your yaks could laugh QUEST	could
will the dog laugh	the dog will laugh QUEST	will
could her yak live	her yak could live QUEST	could
would your unicorns sleep	your unicorns would sleep QUEST	would
can her dogs smile	her dogs can smile QUEST	can
can the dogs smile	the dogs can smile QUEST	can
will your yaks read	your yaks will read QUEST	will
can some yaks read	some yaks can read QUEST	can
could our seal live	our seal could live QUEST	could
would my rabbit smile	my rabbit would smile QUEST	would
would our elephants giggle	our elephants would giggle QUEST	would
would the yaks laugh	the yaks would laugh QUEST	would
could the yak live	the yak could live QUEST	could
will my bird laugh	my bird will laugh QUEST	will
would her seals laugh	her seals would laugh QUEST	would
will some elephant live	some elephant will live QUEST	will
could some elephants smile	some elephants could smile QUEST	could
can our rabbit read	our rabbit can read QUEST	can
will the yak giggle	the yak will giggle QUEST	will
would your cat smile	your cat would smile QUEST	would
would some dog sleep	some dog would sleep QUEST	would
will her dogs read	her dogs will read QUEST	will
can some yaks sleep	some yaks can sleep QUEST	can
could your monkeys read	your monkeys could read QUEST	could
would our dog read	our dog would read QUEST	would
can some cats giggle	some cats can giggle QUEST	can
will my rabbit laugh	my rabbit will laugh QUEST	will
could your dogs live	your dogs could live QUEST	could
can some rabbit laugh	some rabbit can laugh QUEST	can
would your seals live	your seals would live QUEST	would
would my yak live	my yak would live QUEST	would
would her elephants giggle	her elephants would giggle QUEST	would
would her dog live	her dog would live QUEST	would
will the monkeys giggle	the monkeys will giggle QUEST	will
could my elephants smile	my elephants could smile QUEST	could
would my elephants smile	my elephants would smile QUEST	would
would your elephants sleep	your elephants would sleep QUEST	would
can her birds live	her birds can live QUEST	can
will your elephants laugh	your elephants will laugh QUEST	will
would my rabbit live	my rabbit would live QUEST	would
will your unicorns sleep	your unicorns will sleep QUEST	will
can some dogs giggle	some dogs can giggle QUEST	can
could the dogs laugh	the dogs could laugh QUEST	could
would the birds laugh	the birds would laugh QUEST	would
could her dog read	her dog could read QUEST	could
will some rabbit sleep	some rabbit will sleep QUEST	will
would my dogs read	my dogs would read QUEST	would
would my dogs sleep	my dogs would sleep QUEST	would
can your yak laugh	your yak can laugh QUEST	can
could her birds smile	her birds could smile QUEST	could
can your seals live	your seals can live QUEST	can
can your unicorns smile	your unicorns can smile QUEST	can
will the monkey giggle	the monkey will giggle QUEST	will
will my dog read	my dog will read QUEST	will
could some yak giggle	some yak could giggle QUEST	could
could your monkeys sleep	your monkeys could sleep QUEST	could
could our rabbit sleep	our rabbit could sleep QUEST	could
could her elephant giggle	her elephant could giggle QUEST	could
will my seals smile	my seals will smile QUEST	will
can her monkeys giggle	her monkeys can giggle QUEST	can
will my cats read	my cats will read QUEST	will
will her rabbit read	her rabbit will read QUEST	will
can some birds read	some birds can read QUEST	can
will your birds sleep	your birds will sleep QUEST	will
could my elephant giggle	my elephant could giggle QUEST	could
will my unicorns giggle	my unicorns will giggle QUEST	will
can my elephant smile	my elephant can smile QUEST	can
will our monkey live	our monkey will live QUEST	will
would the rabbit read	the rabbit would read QUEST	would
could the cats smile	the cats could smile QUEST	could
could your cats laugh	your cats could laugh QUEST	could
would your unicorns live	your unicorns would live QUEST	would
could my cats read	my cats could read QUEST	could
will the rabbit laugh	the rabbit will laugh QUEST	will
would her dogs laugh	her dogs would laugh QUEST	would
will some birds smile	some birds will smile QUEST	will
can her monkey sleep	her monkey can sleep QUEST	can
would your monkeys live	your monkeys would live QUEST	would
will your monkey read	your monkey will read QUEST	will
will the monkey sleep	the monkey will sleep QUEST	will
will her yaks smile	her yaks will smile QUEST	will
will our seals smile	our seals will smile QUEST	will
will our unicorns read	our unicorns will read QUEST	will
could your cats live	your cats could live QUEST	could
will some monkeys giggle	some monkeys will giggle QUEST	will
can our yaks smile	our yaks can smile QUEST	can
can our monkeys read	our monkeys can read QUEST	can
could some yaks smile	some yaks could smile QUEST	could
could our cats laugh	our cats could laugh QUEST	could
can your unicorns laugh	your unicorns can laugh QUEST	can
would our elephants smile	our elephants would smile QUEST	would
would some elephants giggle	some elephants would giggle QUEST	would
could your unicorn smile	your unicorn could smile QUEST	could
could my bird giggle	my bird could giggle QUEST	could
will our yaks live	our yaks will live QUEST	will
will my dog live	my dog will live QUEST	will
will her bird read	her bird will read QUEST	will
would some monkeys live	some monkeys would live QUEST	would
would our dogs smile	our dogs would smile QUEST	would
could her rabbits giggle	her rabbits could giggle QUEST	could
will some seals giggle	some seals will giggle QUEST	will
will the unicorn giggle	the unicorn will giggle QUEST	will
would the yak giggle	the yak would giggle QUEST	would
could your yaks read	your yaks could read QUEST	could
would some cats read	some cats would read QUEST	would
would our seals laugh	our seals would laugh QUEST	would
can your rabbit laugh	your rabbit can laugh QUEST	can
could my rabbit read	my rabbit could read QUEST	could
will our elephants live	our elephants will live QUEST	will
can some dog read	some dog can read QUEST	can
would the birds sleep	the birds would sleep QUEST	would
can my cats giggle	my cats can giggle QUEST	can
will her bird giggle	her bird will giggle QUEST	will
would the dogs giggle	the dogs would giggle QUEST	would
could our rabbits read	our rabbits could read QUEST	could
would our monkey giggle	our monkey would giggle QUEST	would
can some rabbit laugh	some rabbit can laugh QUEST	can
will the monkeys read	the monkeys will read QUEST	will
would some cat giggle	some cat would giggle QUEST	would
can some rabbit read	some rabbit can read QUEST	can
would the elephants giggle	the elephants would giggle QUEST	would
could your cat sleep	your cat could sleep QUEST	could
would your dog laugh	your dog would laugh QUEST	would
could my seals live	my seals could live QUEST	could
could your elephants laugh	your elephants could laugh QUEST	could
will some rabbits live	some rabbits will live QUEST	will
would some dogs giggle	some dogs would giggle QUEST	would
can our seals live	our seals can live QUEST	can
will some rabbit read	some rabbit will read QUEST	will
would some monkeys read	some monkeys would read QUEST	would
can your bird sleep	your bird can sleep QUEST	can
would your rabbits laugh	your rabbits would laugh QUEST	would
could your bird laugh	your bird could laugh QUEST	could
can some rabbits smile	some rabbits can smile QUEST	can
can your cats live	your cats can live QUEST	can
could my birds live	my birds could live QUEST	could
would some cats sleep	some cats would sleep QUEST	would
will your monkeys laugh	your monkeys will laugh QUEST	will
can the rabbits read	the rabbits can read QUEST	can
can our bird sleep	our bird can sleep QUEST	can
will some unicorn read	some unicorn will read QUEST	will
would the yaks sleep	the yaks would sleep QUEST	would
could the cat giggle	the cat could giggle QUEST	could
could my monkeys read	my monkeys could read QUEST	could
can my monkey laugh	my monkey can laugh QUEST	can
will your yaks live	your yaks will live QUEST	will
would our cat read	our cat would read QUEST	would
would our seal read	our seal would read QUEST	would
would the birds live	the birds would live QUEST	would
can the elephants read	the elephants can read QUEST	can
could the elephant laugh	the elephant could laugh QUEST	could
could your cat giggle	your cat could giggle QUEST	could
would your seal smile	your seal would smile QUEST	would
could our bird live	our bird could live QUEST	could
will our monkey smile	our monkey will smile QUEST	will
can her bird giggle	her bird can giggle QUEST	can
would the seal giggle	the seal would giggle QUEST	would
can my dog live	my dog can live QUEST	can
can my elephants sleep	my elephants can sleep QUEST	can
could some cat smile	some cat could smile QUEST	could
would our unicorns read	our unicorns would read QUEST	would
could my yak sleep	my yak could sleep QUEST	could
will some seals laugh	some seals will laugh QUEST	will
would our monkeys smile	our monkeys would smile QUEST	would
will some rabbit sleep	some rabbit will sleep QUEST	will
would my rabbit sleep	my rabbit would sleep QUEST	would
would your bird giggle	your bird would giggle QUEST	would
can my monkey smile	my monkey can smile QUEST	can
will my yak read	my yak will read QUEST	will
would some yak sleep	some yak would sleep QUEST	would
would my bird smile	my bird would smile QUEST	would
would some cats smile	some cats would smile QUEST	would
can my dogs read	my dogs can read QUEST	can
can the yak laugh	the yak can laugh QUEST	can
can her unicorn laugh	her unicorn can laugh QUEST	can
can her rabbit live	her rabbit can live QUEST	can
could our cats read	our cats could read QUEST	could
would our monkey giggle	our monkey would giggle QUEST	would
will our unicorn smile	our unicorn will smile QUEST	will
can my seals giggle	my seals can giggle QUEST	can
will some cats live	some cats will live QUEST	will
could her rabbits laugh	her rabbits could laugh QUEST	could
will some cats laugh	some cats will laugh QUEST	will
can my seal live	my seal can live QUEST	can
will our rabbit smile	our rabbit will smile QUEST	will
could our monkeys giggle	our monkeys could giggle QUEST	could
will our cat giggle	our cat will giggle QUEST	will
will the yak sleep	the yak will sleep QUEST	will
could my cat sleep	my cat could sleep QUEST	could
will your seal live	your seal will live QUEST	will
will your elephant smile	your elephant will smile QUEST	will
could my seal giggle	my seal could giggle QUEST	could
could our birds laugh	our birds could laugh QUEST	could
would some yak live	some yak would live QUEST	would
will her yaks read	her yaks will read QUEST	will
can your elephants read	your elephants can read QUEST	can
could her seal sleep	her seal could sleep QUEST	could
could your dog laugh	your dog could laugh QUEST	could
could her seals laugh	her seals could laugh QUEST	could
can my cat laugh	my cat can laugh QUEST	can
could her monkey read	her monkey could read QUEST	could
will our bird laugh	our bird will laugh QUEST	will
would our seals live	our seals would live QUEST	would
can my bird read	my bird can read QUEST	can
will my elephant read	my elephant will read QUEST	will
can the bird smile	the bird can smile QUEST	can
can your cats giggle	your cats can giggle QUEST	can
will the rabbits live	the rabbits will live QUEST	will
would your yak laugh	your yak would laugh QUEST	would
could some cat giggle	some cat could giggle QUEST	could
would our seals sleep	our seals would sleep QUEST	would
will our yaks giggle	our yaks will giggle QUEST	will
would the unicorns giggle	the unicorns would giggle QUEST	would
will my bird giggle	my bird will giggle QUEST	will
would my dog sleep	my dog would sleep QUEST	would
can our yaks smile	our yaks can smile QUEST	can
could some monkey read	some monkey could read QUEST	could
would my elephants laugh	my elephants would laugh QUEST	would
can the rabbits laugh	the rabbits can laugh QUEST	can
would my unicorn live	my unicorn would live QUEST	would
would my rabbit read	my rabbit would read QUEST	would
would some monkeys live	some monkeys would live QUEST	would
can her dog giggle	her dog can giggle QUEST	can
can her seal laugh	her seal can laugh QUEST	can
can some birds live	some birds can live QUEST	can
can her seal live	her seal can live QUEST	can
can her rabbit sleep	her rabbit can sleep QUEST	can
will the cat laugh	the cat will laugh QUEST	will
could our unicorns giggle	our unicorns could giggle QUEST	could
could my bird laugh	my bird could laugh QUEST	could
could some yak giggle	some yak could giggle QUEST	could
will some rabbits read	some rabbits will read QUEST	will
would my unicorns read	my unicorns would read QUEST	would
would our monkey read	our monkey would read QUEST	would
would our elephant giggle	our elephant would giggle QUEST	would
will her rabbits sleep	her rabbits will sleep QUEST	will
could your unicorn read	your unicorn could read QUEST	could
would some cats live	some cats would live QUEST	would
could some dog read	some dog could read QUEST	could
will our dogs live	our dogs will live QUEST	will
will my cat smile	my cat will smile QUEST	will
would some elephants read	some elephants would read QUEST	would
will some elephants read	some elephants will read QUEST	will
would some rabbit read	some rabbit would read QUEST	would
would our rabbit sleep	our rabbit would sleep QUEST	would
will our monkey read	our monkey will read QUEST	will
can some yaks giggle	some yaks can giggle QUEST	can
will your rabbit read	your rabbit will read QUEST	will
can the birds laugh	the birds can laugh QUEST	can
can the elephant read	the elephant can read QUEST	can
would some seal giggle	some seal would giggle QUEST	would
would the seals smile	the seals would smile QUEST	would
can her rabbit sleep	her rabbit can sleep QUEST	can
could my elephant laugh	my elephant could laugh QUEST	could
would our birds smile	our birds would smile QUEST	would
would the dogs read	the dogs would read QUEST	would
could the monkeys giggle	the monkeys could giggle QUEST	could
would some rabbits giggle	some rabbits would giggle QUEST	would
will my monkey smile	my monkey will smile QUEST	will
can your rabbits sleep	your rabbits can sleep QUEST	can
can my unicorn sleep	my unicorn can sleep QUEST	can
would our birds giggle	our birds would giggle QUEST	would
will some unicorns laugh	some unicorns will laugh QUEST	will
can my unicorns read	my unicorns can read QUEST	can
can some unicorns sleep	some unicorns can sleep QUEST	can
can some monkeys smile	some monkeys can smile QUEST	can
can some rabbits laugh	some rabbits can laugh QUEST	can
would some yak sleep	some yak would sleep QUEST	would
would the monkeys giggle	the monkeys would giggle QUEST	would
would our rabbits giggle	our rabbits would giggle QUEST	would
could her yaks sleep	her yaks could sleep QUEST	could
would your seal read	your seal would read QUEST	would
can your cat sleep	your cat can sleep QUEST	can
would our dog smile	our dog would smile QUEST	would
could our cat smile	our cat could smile QUEST	could
would some rabbits read	some rabbits would read QUEST	would
could her elephant laugh	her elephant could laugh QUEST	could
can her yak sleep	her yak can sleep QUEST	can
would her elephants read	her elephants would read QUEST	would
will the unicorn giggle	the unicorn will giggle QUEST	will
would the cat giggle	the cat would giggle QUEST	would
will her cat giggle	her cat will giggle QUEST	will
will my yaks live	my yaks will live QUEST	will
can your seal sleep	your seal can sleep QUEST	can
would some elephant sleep	some elephant would sleep QUEST	would
would my yak live	my yak would live QUEST	would
would your yak live	your yak would live QUEST	would
can her yak giggle	her yak can giggle QUEST	can
will the rabbits laugh	the rabbits will laugh QUEST	will
would our dog smile	our dog would smile QUEST	would
can her rabbits sleep	her rabbits can sleep QUEST	can
can her unicorn sleep	her unicorn can sleep QUEST	can
would the elephants giggle	the elephants would giggle QUEST	would
would your yaks giggle	your yaks would giggle QUEST	would
can my bird live	my bird can live QUEST	can
will her bird giggle	her bird will giggle QUEST	will
will her unicorns giggle	her unicorns will giggle QUEST	will
would some rabbit smile	some rabbit would smile QUEST	would
can my rabbit read	my rabbit can read QUEST	can
can your monkeys smile	your monkeys can smile QUEST	can
will my cats laugh	my cats will laugh QUEST	will
could your elephant giggle	your elephant could giggle QUEST	could
would our dog read	our dog would read QUEST	would
will our yaks smile	our yaks will smile QUEST	will
can your cat sleep	your cat can sleep QUEST	can
will her cats giggle	her cats will giggle QUEST	will
can her elephants read	her elephants can read QUEST	can
can her monkeys read	her monkeys can read QUEST	can
would our cat read	our cat would read QUEST	would
could my bird live	my bird could live QUEST	could
would some birds read	some birds would read QUEST	would
can the rabbits read	the rabbits can read QUEST	can
could our monkey live	our monkey could live QUEST	could
would our unicorns live	our unicorns would live QUEST	would
could our rabbits laugh	our rabbits could laugh QUEST	could
could my elephants giggle	my elephants could giggle QUEST	could
would our rabbits live	our rabbits would live QUEST	would
would your monkey giggle	your monkey would giggle QUEST	would
could your unicorns smile	your unicorns could smile QUEST	could
could my dog sleep	my dog could sleep QUEST	could
could your dog sleep	your dog could sleep QUEST	could
will her monkey smile	her monkey will smile QUEST	will
would the unicorns giggle	the unicorns would giggle QUEST	would
could your unicorns smile	your unicorns could smile QUEST	could
would my dog giggle	my dog would giggle QUEST	would
can our seals giggle	our seals can giggle QUEST	can
could her cat giggle	her cat could giggle QUEST	could
can her elephants read	her elephants can read QUEST	can
would your dog laugh	your dog would laugh QUEST	would
will your cats sleep	your cats will sleep QUEST	will
could your bird read	your bird could read QUEST	could
can my bird sleep	my bird can sleep QUEST	can
would some birds sleep	some birds would sleep QUEST	would
could some seal read	some seal could read QUEST	could
would the yak sleep	the yak would sleep QUEST	would
can the rabbit smile	the rabbit can smile QUEST	can
could our yak live	our yak could live QUEST	could
can our dogs live	our dogs can live QUEST	can
can my dog laugh	my dog can laugh QUEST	can
would some dogs smile	some dogs would smile QUEST	would
could the monkey read	the monkey could read QUEST	could
would her monkey laugh	her monkey would laugh QUEST	would
could her monkey laugh	her monkey could laugh QUEST	could
will her monkey sleep	her monkey will sleep QUEST	will
would the dogs smile	the dogs would smile QUEST	would
will her seal sleep	her seal will sleep QUEST	will
will her cat sleep	her cat will sleep QUEST	will
would our cats sleep	our cats would sleep QUEST	would
can her cat laugh	her cat can laugh QUEST	can
could some yaks sleep	some yaks could sleep QUEST	could
will your cats giggle	your cats will giggle QUEST	will
would her yaks read	her yaks would read QUEST	would
would our dog giggle	our dog would giggle QUEST	would
could my seal giggle	my seal could giggle QUEST	could
could her seal laugh	her seal could laugh QUEST	could
will the bird laugh	the bird will laugh QUEST	will
would her dog giggle	her dog would giggle QUEST	would
would your monkeys smile	your monkeys would smile QUEST	would
will your birds smile	your birds will smile QUEST	will
can the rabbits giggle	the rabbits can giggle QUEST	can
could your bird smile	your bird could smile QUEST	could
would the yaks giggle	the yaks would giggle QUEST	would
could my dogs read	my dogs could read QUEST	could
can her seals giggle	her seals can giggle QUEST	can
could her seals giggle	her seals could giggle QUEST	could
would her yak smile	her yak would smile QUEST	would
could her bird giggle	her bird could giggle QUEST	could
would the cats smile	the cats would smile QUEST	would
will our unicorns giggle	our unicorns will giggle QUEST	will
could her seals sleep	her seals could sleep QUEST	could
will some cats live	some cats will live QUEST	will
will your dog sleep	your dog will sleep QUEST	will
could your bird read	your bird could read QUEST	could
can your seal sleep	your seal can sleep QUEST	can
would the monkeys giggle	the monkeys would giggle QUEST	would
would your cats giggle	your cats would giggle QUEST	would
will my seals smile	my seals will smile QUEST	will
can my elephant sleep	my elephant can sleep QUEST	can
could the seals smile	the seals could smile QUEST	could
would your dog smile	your dog would smile QUEST	would
would her unicorn laugh	her unicorn would laugh QUEST	would
would her unicorn smile	her unicorn would smile QUEST	would
will our birds giggle	our birds will giggle QUEST	will
can the dog giggle	the dog can giggle QUEST	can
can the yak laugh	the yak can laugh QUEST	can
would the monkey laugh	the monkey would laugh QUEST	would
would our yaks read	our yaks would read QUEST	would
can your elephants laugh	your elephants can laugh QUEST	can
could your elephants laugh	your elephants could laugh QUEST	could
could your elephants read	your elephants could read QUEST	could
can your rabbits read	your rabbits can read QUEST	can
could your rabbits smile	your rabbits could smile QUEST	could
could our seals sleep	our seals could sleep QUEST	could
could her seal read	her seal could read QUEST	could
can your elephants smile	your elephants can smile QUEST	can
can the unicorn sleep	the unicorn can sleep QUEST	can
could my unicorns laugh	my unicorns could laugh QUEST	could
could my dogs read	my dogs could read QUEST	could
can some dogs sleep	some dogs can sleep QUEST	can
can her dogs laugh	her dogs can laugh QUEST	can
will your dogs sleep	your dogs will sleep QUEST	will
can your unicorns sleep	your unicorns can sleep QUEST	can
will some monkey laugh	some monkey will laugh QUEST	will
will some bird read	some bird will read QUEST	will
can my yaks giggle	my yaks can giggle QUEST	can
can some elephants giggle	some elephants can giggle QUEST	can
can my yaks read	my yaks can read QUEST	can
would the elephant sleep	the elephant would sleep QUEST	would
can our seals laugh	our seals can laugh QUEST	can
would my monkey sleep	my monkey would sleep QUEST	would
could our dogs live	our dogs could live QUEST	could
can her bird giggle	her bird can giggle QUEST	can
will some elephant live	some elephant will live QUEST	will
can some elephant giggle	some elephant can giggle QUEST	can
could some dogs read	some dogs could read QUEST	could
can some rabbit live	some rabbit can live QUEST	can
would my elephants giggle	my elephants would giggle QUEST	would
could our dog smile	our dog could smile QUEST	could
can the monkeys sleep	the monkeys can sleep QUEST	can
could your cats giggle	your cats could giggle QUEST	could
would some dog giggle	some dog would giggle QUEST	would
can our seal read	our seal can read QUEST	can
would some seal smile	some seal would smile QUEST	would
will your seal laugh	your seal will laugh QUEST	will
will your seal smile	your seal will smile QUEST	will
will your rabbit smile	your rabbit will smile QUEST	will
can her seals smile	her seals can smile QUEST	can
will her rabbit smile	her rabbit will smile QUEST	will
will our cats read	our cats will read QUEST	will
will her yaks giggle	her yaks will giggle QUEST	will
would your elephants sleep	your elephants would sleep QUEST	would
could her elephant smile	her elephant could smile QUEST	could
would the seal sleep	the seal would sleep QUEST	would
will your cat sleep	your cat will sleep QUEST	will
will her seals live	her seals will live QUEST	will
will my dogs live	my dogs will live QUEST	will
could my seals live	my seals could live QUEST	could
would some yak sleep	some yak would sleep QUEST	would
would some birds sleep	some birds would sleep QUEST	would
can some cat sleep	some cat can sleep QUEST	can
can some elephants laugh	some elephants can laugh QUEST	can
could your bird giggle	your bird could giggle QUEST	could
would our rabbits read	our rabbits would read QUEST	would
can your yak live	your yak can live QUEST	can
will your cat laugh	your cat will laugh QUEST	will
would my elephant laugh	my elephant would laugh QUEST	would
could your unicorn smile	your unicorn could smile QUEST	could
could our unicorn laugh	our unicorn could laugh QUEST	could
will our birds sleep	our birds will sleep QUEST	will
will your dogs giggle	your dogs will giggle QUEST	will
could your rabbit smile	your rabbit could smile QUEST	could
can your rabbit laugh	your rabbit can laugh QUEST	can
would my dogs live	my dogs would live QUEST	would
would your unicorn read	your unicorn would read QUEST	would
could the unicorns sleep	the unicorns could sleep QUEST	could
could my elephants read	my elephants could read QUEST	could
will my yaks smile	my yaks will smile QUEST	will
can our monkeys read	our monkeys can read QUEST	can
will your bird giggle	your bird will giggle QUEST	will
can the cat read	the cat can read QUEST	can
would the elephants live	the elephants would live QUEST	would
could our rabbits sleep	our rabbits could sleep QUEST	could
would our rabbits live	our rabbits would live QUEST	would
could your rabbits read	your rabbits could read QUEST	could
will some dogs laugh	some dogs will laugh QUEST	will
would my rabbits read	my rabbits would read QUEST	would
would some bird read	some bird would read QUEST	would
will some rabbits laugh	some rabbits will laugh QUEST	will
would your unicorns smile	your unicorns would smile QUEST	would
would your birds smile	your birds would smile QUEST	would
would the birds smile	the birds would smile QUEST	would
could the unicorn smile	the unicorn could smile QUEST	could
will my yaks giggle	my yaks will giggle QUEST	will
will the dog smile	the dog will smile QUEST	will
would my unicorns giggle	my unicorns would giggle QUEST	would
can my dogs sleep	my dogs can sleep QUEST	can
will some unicorn giggle	some unicorn will giggle QUEST	will
would our unicorns live	our unicorns would live QUEST	would
can her dog giggle	her dog can giggle QUEST	can
can your elephants sleep	your elephants can sleep QUEST	can
could our cat giggle	our cat could giggle QUEST	could
would your dog read	your dog would read QUEST	would
will the birds read	the birds will read QUEST	will
can the cat giggle	the cat can giggle QUEST	can
would the unicorn smile	the unicorn would smile QUEST	would
can her elephant smile	her elephant can smile QUEST	can
can her unicorn laugh	her unicorn can laugh QUEST	can
can her elephants live	her elephants can live QUEST	can
would her monkey live	her monkey would live QUEST	would
will some dogs giggle	some dogs will giggle QUEST	will
could our yak read	our yak could read QUEST	could
would the rabbit live	the rabbit would live QUEST	would
will your yaks sleep	your yaks will sleep QUEST	will
can your monkeys laugh	your monkeys can laugh QUEST	can
can my dogs read	my dogs can read QUEST	can
can my dogs giggle	my dogs can giggle QUEST	can
will your yaks live	your yaks will live QUEST	will
can some rabbit read	some rabbit can read QUEST	can
will your cat giggle	your cat will giggle QUEST	will
can our monkeys laugh	our monkeys can laugh QUEST	can
can the dog giggle	the dog can giggle QUEST	can
can your dogs live	your dogs can live QUEST	can
can some elephant read	some elephant can read QUEST	can
would some elephant giggle	some elephant would giggle QUEST	would
could the rabbits laugh	the rabbits could laugh QUEST	could
would our yaks smile	our yaks would smile QUEST	would
could my cats giggle	my cats could giggle QUEST	could
can our seals giggle	our seals can giggle QUEST	can
could her unicorn read	her unicorn could read QUEST	could
will her seals live	her seals will live QUEST	will
can my dogs laugh	my dogs can laugh QUEST	can
could my monkey laugh	my monkey could laugh QUEST	could
can your elephant smile	your elephant can smile QUEST	can
will your dog sleep	your dog will sleep QUEST	will
would my elephants sleep	my elephants would sleep QUEST	would
could her monkeys giggle	her monkeys could giggle QUEST	could
will her dogs giggle	her dogs will giggle QUEST	will
would our yak laugh	our yak would laugh QUEST	would
can your yaks smile	your yaks can smile QUEST	can
would some yak live	some yak would live QUEST	would
can some yak giggle	some yak can giggle QUEST	can
can my cats live	my cats can live QUEST	can
could your dogs laugh	your dogs could laugh QUEST	could
will your cats sleep	your cats will sleep QUEST	will
will her elephants giggle	her elephants will giggle QUEST	will
would my unicorns smile	my unicorns would smile QUEST	would
would the birds smile	the birds would smile QUEST	would
can some yak giggle	some yak can giggle QUEST	can
would her bird giggle	her bird would giggle QUEST	would
will some monkey sleep	some monkey will sleep QUEST	will
could my unicorn live	my unicorn could live QUEST	could
will some unicorn laugh	some unicorn will laugh QUEST	will
can my rabbit live	my rabbit can live QUEST	can
will your cats giggle	your cats will giggle QUEST	will
can her birds laugh	her birds can laugh QUEST	can
could the birds giggle	the birds could giggle QUEST	could
will my seals live	my seals will live QUEST	will
could your unicorns laugh	your unicorns could laugh QUEST	could
could some unicorns sleep	some unicorns could sleep QUEST	could
would my monkeys sleep	my monkeys would sleep QUEST	would
can our unicorn sleep	our unicorn can sleep QUEST	can
will some unicorn read	some unicorn will read QUEST	will
can our rabbit smile	our rabbit can smile QUEST	can
could your seal sleep	your seal could sleep QUEST	could
could the monkeys read	the monkeys could read QUEST	could
can her yaks smile	her yaks can smile QUEST	can
can some cats laugh	some cats can laugh QUEST	can
will our seal read	our seal will read QUEST	will
could some rabbit sleep	some rabbit could sleep QUEST	could
can the birds sleep	the birds can sleep QUEST	can
can her elephants smile	her elephants can smile QUEST	can
could my rabbits sleep	my rabbits could sleep QUEST	could
would her seal sleep	her seal would sleep QUEST	would
will my monkeys laugh	my monkeys will laugh QUEST	will
will our unicorn smile	our unicorn will smile QUEST	will
could some elephants laugh	some elephants could laugh QUEST	could
would some cat live	some cat would live QUEST	would
would some seal sleep	some seal would sleep QUEST	would
would the seals giggle	the seals would giggle QUEST	would
will her dog laugh	her dog will laugh QUEST	will
could our unicorn sleep	our unicorn could sleep QUEST	could
can my bird read	my bird can read QUEST	can
can my bird laugh	my bird can laugh QUEST	can
would your birds live	your birds would live QUEST	would
could her birds live	her birds could live QUEST	could
would your yaks giggle	your yaks would giggle QUEST	would
would my seal smile	my seal would smile QUEST	would
would her unicorn giggle	her unicorn would giggle QUEST	would
will the monkeys giggle	the monkeys will giggle QUEST	will
would the birds live	the birds would live QUEST	would
will her dog smile	her dog will smile QUEST	will
can the dog live	the dog can live QUEST	can
will our bird giggle	our bird will giggle QUEST	will
could the unicorns sleep	the unicorns could sleep QUEST	could
will my rabbits live	my rabbits will live QUEST	will
would the monkeys read	the monkeys would read QUEST	would
would our seal smile	our seal would smile QUEST	would
could the unicorn sleep	the unicorn could sleep QUEST	could
will her yak live	her yak will live QUEST	will
will my unicorns read	my unicorns will read QUEST	will
would your elephants smile	your elephants would smile QUEST	would
can my yak live	my yak can live QUEST	can
could your bird smile	your bird could smile QUEST	could
can your unicorn sleep	your unicorn can sleep QUEST	can
could your unicorn read	your unicorn could read QUEST	could
could the unicorn read	the unicorn could read QUEST	could
could the cat sleep	the cat could sleep QUEST	could
can my dogs giggle	my dogs can giggle QUEST	can
can her birds sleep	her birds can sleep QUEST	can
can my birds live	my birds can live QUEST	can
could my seal read	my seal could read QUEST	could
can her bird read	her bird can read QUEST	can
would my yaks sleep	my yaks would sleep QUEST	would
could your seals laugh	your seals could laugh QUEST	could
can her elephants laugh	her elephants can laugh QUEST	can
will her yak read	her yak will read QUEST	will
would my rabbit smile	my rabbit would smile QUEST	would
will my unicorn live	my unicorn will live QUEST	will
will your rabbit read	your rabbit will read QUEST	will
will your dogs sleep	your dogs will sleep QUEST	will
will my bird read	my bird will read QUEST	will
could the dogs read	the dogs could read QUEST	could
will the elephant laugh	the elephant will laugh QUEST	will
can our elephant read	our elephant can read QUEST	can
can some rabbit giggle	some rabbit can giggle QUEST	can
can some birds giggle	some birds can giggle QUEST	can
would her cats giggle	her cats would giggle QUEST	would
would some elephants sleep	some elephants would sleep QUEST	would
would some seal laugh	some seal would laugh QUEST	would
can our bird smile	our bird can smile QUEST	can
can our elephants giggle	our elephants can giggle QUEST	can
would your bird giggle	your bird would giggle QUEST	would
would your unicorn laugh	your unicorn would laugh QUEST	would
can the cats live	the cats can live QUEST	can
can some cats laugh	some cats can laugh QUEST	can
would the elephant giggle	the elephant would giggle QUEST	would
could your seals live	your seals could live QUEST	could
will her unicorn giggle	her unicorn will giggle QUEST	will
could her dog laugh	her dog could laugh QUEST	could
can some yak sleep	some yak can sleep QUEST	can
can your birds giggle	your birds can giggle QUEST	can
could your seal laugh	your seal could laugh QUEST	could
could her birds laugh	her birds could laugh QUEST	could
could my monkey live	my monkey could live QUEST	could
could your dogs live	your dogs could live QUEST	could
could my seal sleep	my seal could sleep QUEST	could
would our dogs giggle	our dogs would giggle QUEST	would
could my elephants laugh	my elephants could laugh QUEST	could
will our cat sleep	our cat will sleep QUEST	will
will your unicorns sleep	your unicorns will sleep QUEST	will
could your monkeys sleep	your monkeys could sleep QUEST	could
will the yak laugh	the yak will laugh QUEST	will
would our seal live	our seal would live QUEST	would
would some bird sleep	some bird would sleep QUEST	would
will her monkeys giggle	her monkeys will giggle QUEST	will
can your dogs smile	your dogs can smile QUEST	can
would some unicorns laugh	some unicorns would laugh QUEST	would
can my elephant live	my elephant can live QUEST	can
can my cats smile	my cats can smile QUEST	can
can your rabbits live	your rabbits can live QUEST	can
can your rabbit smile	your rabbit can smile QUEST	can
can your bird smile	your bird can smile QUEST	can
can your seals sleep	your seals can sleep QUEST	can
would my cats live	my cats would live QUEST	would
would the seals giggle	the seals would giggle QUEST	would
could our bird read	our bird could read QUEST	could
will our dog sleep	our dog will sleep QUEST	will
could her yaks sleep	her yaks could sleep QUEST	could
could our yaks giggle	our yaks could giggle QUEST	could
could my seal read	my seal could read QUEST	could
could the yaks read	the yaks could read QUEST	could
will the unicorn giggle	the unicorn will giggle QUEST	will
would her seals read	her seals would read QUEST	would
could the dog giggle	the dog could giggle QUEST	could
could some rabbit giggle	some rabbit could giggle QUEST	could
could your yak read	your yak could read QUEST	could
will our rabbit laugh	our rabbit will laugh QUEST	will
would her elephant read	her elephant would read QUEST	would
will my unicorns giggle	my unicorns will giggle QUEST	will
would my yak read	my yak would read QUEST	would
would your yaks smile	your yaks would smile QUEST	would
would some unicorns giggle	some unicorns would giggle QUEST	would
would her dogs read	her dogs would read QUEST	would
will her dogs smile	her dogs will smile QUEST	will
could your seals laugh	your seals could laugh QUEST	could
could some unicorns read	some unicorns could read QUEST	could
could her dog live	her dog could live QUEST	could
will your elephant read	your elephant will read QUEST	will
will our yak smile	our yak will smile QUEST	will
can our cats laugh	our cats can laugh QUEST	can
would some cat laugh	some cat would laugh QUEST	would
could the unicorns laugh	the unicorns could laugh QUEST	could
would my unicorns smile	my unicorns would smile QUEST	would
would your cat smile	your cat would smile QUEST	would
can her unicorn smile	her unicorn can smile QUEST	can
could the monkeys read	the monkeys could read QUEST	could
could the birds read	the birds could read QUEST	could
can your unicorns giggle	your unicorns can giggle QUEST	can
could some rabbit laugh	some rabbit could laugh QUEST	could
will some elephant smile	some elephant will smile QUEST	will
would our unicorn sleep	our unicorn would sleep QUEST	would
can the seals live	the seals can live QUEST	can
could her elephant giggle	her elephant could giggle QUEST	could
can the rabbits laugh	the rabbits can laugh QUEST	can
could our monkey read	our monkey could read QUEST	could
would some birds sleep	some birds would sleep QUEST	would
could your elephant sleep	your elephant could sleep QUEST	could
would my elephant smile	my elephant would smile QUEST	would
would her rabbit read	her rabbit would read QUEST	would
would the seals sleep	the seals would sleep QUEST	would
would your bird laugh	your bird would laugh QUEST	would
will my unicorn read	my unicorn will read QUEST	will
would her monkeys laugh	her monkeys would laugh QUEST	would
will the rabbits read	the rabbits will read QUEST	will
could our elephants laugh	our elephants could laugh QUEST	could
can your dog live	your dog can live QUEST	can
could her seals laugh	her seals could laugh QUEST	could
can our seals laugh	our seals can laugh QUEST	can
will my unicorn sleep	my unicorn will sleep QUEST	will
would your monkeys sleep	your monkeys would sleep QUEST	would
can your rabbits smile	your rabbits can smile QUEST	can
will your elephants smile	your elephants will smile QUEST	will
could her cat laugh	her cat could laugh QUEST	could
will our bird giggle	our bird will giggle QUEST	will
would our cats smile	our cats would smile QUEST	would
can her dog laugh	her dog can laugh QUEST	can
will her rabbit read	her rabbit will read QUEST	will
would her bird laugh	her bird would laugh QUEST	would
could some cats smile	some cats could smile QUEST	could
would my cats smile	my cats would smile QUEST	would
will my dog giggle	my dog will giggle QUEST	will
would the seal sleep	the seal would sleep QUEST	would
can the cats laugh	the cats can laugh QUEST	can
would our elephant read	our elephant would read QUEST	would
could my monkeys giggle	my monkeys could giggle QUEST	could
could her elephants live	her elephants could live QUEST	could
will your elephants live	your elephants will live QUEST	will
could her yaks read	her yaks could read QUEST	could
could the elephant smile	the elephant could smile QUEST	could
would the seals read	the seals would read QUEST	would
can her bird giggle	her bird can giggle QUEST	can
could our monkeys read	our monkeys could read QUEST	could
could your elephant giggle	your elephant could giggle QUEST	could
will my yaks laugh	my yaks will laugh QUEST	will
could our dogs giggle	our dogs could giggle QUEST	could
can some elephants sleep	some elephants can sleep QUEST	can
would our cat read	our cat would read QUEST	would
would our yaks laugh	our yaks would laugh QUEST	would
can our unicorns giggle	our unicorns can giggle QUEST	can
would some yaks laugh	some yaks would laugh QUEST	would
can some yaks laugh	some yaks can laugh QUEST	can
can some elephant smile	some elephant can smile QUEST	can
will some dog giggle	some dog will giggle QUEST	will
can her elephants laugh	her elephants can laugh QUEST	can
would our rabbit live	our rabbit would live QUEST	would
will my cats smile	my cats will smile QUEST	will
will the cat giggle	the cat will giggle QUEST	will
will her cat live	her cat will live QUEST	will
can our seal sleep	our seal can sleep QUEST	can
can the rabbits giggle	the rabbits can giggle QUEST	can
would my monkeys giggle	my monkeys would giggle QUEST	would
can her rabbit read	her rabbit can read QUEST	can
would our unicorn smile	our unicorn would smile QUEST	would
can my elephants sleep	my elephants can sleep QUEST	can
will her birds smile	her birds will smile QUEST	will
could my birds read	my birds could read QUEST	could
could her monkey laugh	her monkey could laugh QUEST	could
would the monkey read	the monkey would read QUEST	would
will my birds smile	my birds will smile QUEST	will
can my yaks smile	my yaks can smile QUEST	can
will your rabbits giggle	your rabbits will giggle QUEST	will
will my rabbits giggle	my rabbits will giggle QUEST	will
will our birds read	our birds will read QUEST	will
will her dog laugh	her dog will laugh QUEST	will
can your unicorn sleep	your unicorn can sleep QUEST	can
would her rabbits live	her rabbits would live QUEST	would
will her seals giggle	her seals will giggle QUEST	will
would your monkey smile	your monkey would smile QUEST	would
will the elephants smile	the elephants will smile QUEST	will
could my monkeys live	my monkeys could live QUEST	could
can our monkeys laugh	our monkeys can laugh QUEST	can
will our dog smile	our dog will smile QUEST	will
will her seal sleep	her seal will sleep QUEST	will
will her dogs sleep	her dogs will sleep QUEST	will
could some unicorns sleep	some unicorns could sleep QUEST	could
could the yaks live	the yaks could live QUEST	could
can the seal smile	the seal can smile QUEST	can
would my dogs live	my dogs would live QUEST	would
will our cat sleep	our cat will sleep QUEST	will
could the cats read	the cats could read QUEST	could
could my unicorns smile	my unicorns could smile QUEST	could
would your rabbit live	your rabbit would live QUEST	would
can my seals giggle	my seals can giggle QUEST	can
will my unicorns laugh	my unicorns will laugh QUEST	will
will some cat read	some cat will read QUEST	will
would the rabbit sleep	the rabbit would sleep QUEST	would
can the seal sleep	the seal can sleep QUEST	can
will some cats smile	some cats will smile QUEST	will
can my cats sleep	my cats can sleep QUEST	can
will the bird laugh	the bird will laugh QUEST	will
can some unicorns read	some unicorns can read QUEST	can
would our elephants laugh	our elephants would laugh QUEST	would
can our monkey laugh	our monkey can laugh QUEST	can
will some cat laugh	some cat will laugh QUEST	will
can the elephant sleep	the elephant can sleep QUEST	can
could your monkeys sleep	your monkeys could sleep QUEST	could
could your unicorn sleep	your unicorn could sleep QUEST	could
will the birds sleep	the birds will sleep QUEST	will
can some cats laugh	some cats can laugh QUEST	can
can our dogs read	our dogs can read QUEST	can
can my dog read	my dog can read QUEST	can
will the seal live	the seal will live QUEST	will
will the elephants read	the elephants will read QUEST	will
would the dogs read	the dogs would read QUEST	would
could your unicorn sleep	your unicorn could sleep QUEST	could
would her unicorn sleep	her unicorn would sleep QUEST	would
can the yak smile	the yak can smile QUEST	can
will the unicorns read	the unicorns will read QUEST	will
would her unicorns live	her unicorns would live QUEST	would
can her unicorns laugh	her unicorns can laugh QUEST	can
could your cats smile	your cats could smile QUEST	could
can your cats giggle	your cats can giggle QUEST	can
could my rabbit live	my rabbit could live QUEST	could
could some monkeys live	some monkeys could live QUEST	could
could some rabbit live	some rabbit could live QUEST	could
would my cat read	my cat would read QUEST	would
could her yaks sleep	her yaks could sleep QUEST	could
can the unicorn giggle	the unicorn can giggle QUEST	can
could her yak live	her yak could live QUEST	could
would our rabbit laugh	our rabbit would laugh QUEST	would
could my rabbit smile	my rabbit could smile QUEST	could
could the monkeys smile	the monkeys could smile QUEST	could
could some bird sleep	some bird could sleep QUEST	could
can her monkey smile	her monkey can smile QUEST	can
could my dog giggle	my dog could giggle QUEST	could
will the yaks smile	the yaks will smile QUEST	will
could your rabbits read	your rabbits could read QUEST	could
will my elephant smile	my elephant will smile QUEST	will
will my yaks smile	my yaks will smile QUEST	will
would your cat sleep	your cat would sleep QUEST	would
can your unicorns laugh	your unicorns can laugh QUEST	can
could your seal read	your seal could read QUEST	could
would your unicorn live	your unicorn would live QUEST	would
could her rabbits smile	her rabbits could smile QUEST	could
will my elephants giggle	my elephants will giggle QUEST	will
can the elephant smile	the elephant can smile QUEST	can
can some yaks read	some yaks can read QUEST	can
would some rabbit live	some rabbit would live QUEST	would
will her cats live	her cats will live QUEST	will
could my cats giggle	my cats could giggle QUEST	could
would some cat laugh	some cat would laugh QUEST	would
can your birds sleep	your birds can sleep QUEST	can
would our monkey giggle	our monkey would giggle QUEST	would
could her unicorn giggle	her unicorn could giggle QUEST	could
would the cats live	the cats would live QUEST	would
could my rabbits read	my rabbits could read QUEST	could
could the elephant giggle	the elephant could giggle QUEST	could
will my unicorn sleep	my unicorn will sleep QUEST	will
can the monkey smile	the monkey can smile QUEST	can
would your monkey live	your monkey would live QUEST	would
can your yaks laugh	your yaks can laugh QUEST	can
will your cat live	your cat will live QUEST	will
could your bird laugh	your bird could laugh QUEST	could
can your yaks smile	your yaks can smile QUEST	can
would your dogs smile	your dogs would smile QUEST	would
would the yak giggle	the yak would giggle QUEST	would
can her elephant read	her elephant can read QUEST	can
can my unicorn sleep	my unicorn can sleep QUEST	can
will my birds sleep	my birds will sleep QUEST	will
could the elephants read	the elephants could read QUEST	could
could some elephants smile	some elephants could smile QUEST	could
will your seal laugh	your seal will laugh QUEST	will
could some unicorns sleep	some unicorns could sleep QUEST	could
would some unicorns sleep	some unicorns would sleep QUEST	would
will her monkeys smile	her monkeys will smile QUEST	will
can our unicorns giggle	our unicorns can giggle QUEST	can
can the unicorns read	the unicorns can read QUEST	can
can our cats read	our cats can read QUEST	can
can our seal read	our seal can read QUEST	can
could her bird giggle	her bird could giggle QUEST	could
will some cats giggle	some cats will giggle QUEST	will
can some yaks smile	some yaks can smile QUEST	can
would your cat read	your cat would read QUEST	would
could some yaks sleep	some yaks could sleep QUEST	could
would our seal smile	our seal would smile QUEST	would
will our unicorns laugh	our unicorns will laugh QUEST	will
would the monkey giggle	the monkey would giggle QUEST	would
will my yak live	my yak will live QUEST	will
could your monkeys smile	your monkeys could smile QUEST	could
could our yak laugh	our yak could laugh QUEST	could
would our seal laugh	our seal would laugh QUEST	would
would your yaks giggle	your yaks would giggle QUEST	would
can some unicorns sleep	some unicorns can sleep QUEST	can
could your cats live	your cats could live QUEST	could
could her monkey read	her monkey could read QUEST	could
will the monkey giggle	the monkey will giggle QUEST	will
would some unicorn smile	some unicorn would smile QUEST	would
will your yak live	your yak will live QUEST	will
would my rabbits read	my rabbits would read QUEST	would
will your monkeys read	your monkeys will read QUEST	will
could my birds laugh	my birds could laugh QUEST	could
will her monkeys live	her monkeys will live QUEST	will
could our birds read	our birds could read QUEST	could
could your dog smile	your dog could smile QUEST	could
would your unicorn giggle	your unicorn would giggle QUEST	would
could your yak laugh	your yak could laugh QUEST	could
will your bird read	your bird will read QUEST	will
can my seals giggle	my seals can giggle QUEST	can
could the unicorns sleep	the unicorns could sleep QUEST	could
will some unicorn read	some unicorn will read QUEST	will
can some rabbits live	some rabbits can live QUEST	can
will my bird smile	my bird will smile QUEST	will
could my seals giggle	my seals could giggle QUEST	could
will the yaks giggle	the yaks will giggle QUEST	will
could my bird smile	my bird could smile QUEST	could
would my rabbits live	my rabbits would live QUEST	would
will her cats giggle	her cats will giggle QUEST	will
could my yaks live	my yaks could live QUEST	could
could the unicorns read	the unicorns could read QUEST	could
can her seals sleep	her seals can sleep QUEST	can
could the birds smile	the birds could smile QUEST	could
can our dogs read	our dogs can read QUEST	can
will the seals read	the seals will read QUEST	will
can the dog read	the dog can read QUEST	can
can our monkey sleep	our monkey can sleep QUEST	can
would some yak live	some yak would live QUEST	would
would her elephant read	her elephant would read QUEST	would
would your bird laugh	your bird would laugh QUEST	would
will our cats laugh	our cats will laugh QUEST	will
will her seals live	her seals will live QUEST	will
would the bird read	the bird would read QUEST	would
will the dog live	the dog will live QUEST	will
will the seals smile	the seals will smile QUEST	will
could my unicorn sleep	my unicorn could sleep QUEST	could
would my monkeys smile	my monkeys would smile QUEST	would
could my dogs giggle	my dogs could giggle QUEST	could
would her rabbits live	her rabbits would live QUEST	would
will her yak live	her yak will live QUEST	will
will the cats live	the cats will live QUEST	will
will the cat live	the cat will live QUEST	will
would your birds live	your birds would live QUEST	would
can our seals sleep	our seals can sleep QUEST	can
could her elephant live	her elephant could live QUEST	could
would your unicorn giggle	your unicorn would giggle QUEST	would
would some cats laugh	some cats would laugh QUEST	would
would some monkey sleep	some monkey would sleep QUEST	would
will some rabbit smile	some rabbit will smile QUEST	will
could some cats smile	some cats could smile QUEST	could
would some seal read	some seal would read QUEST	would
will some seal live	some seal will live QUEST	will
could some seal sleep	some seal could sleep QUEST	could
can some seal smile	some seal can smile QUEST	can
can some dogs sleep	some dogs can sleep QUEST	can
can my monkeys sleep	my monkeys can sleep QUEST	can
can her unicorn sleep	her unicorn can sleep QUEST	can
can my dogs giggle	my dogs can giggle QUEST	can
can some unicorns giggle	some unicorns can giggle QUEST	can
could my cats live	my cats could live QUEST	could
can our rabbit read	our rabbit can read QUEST	can
would your dogs sleep	your dogs would sleep QUEST	would
will your rabbits live	your rabbits will live QUEST	will
will your unicorn smile	your unicorn will smile QUEST	will
would some unicorns sleep	some unicorns would sleep QUEST	would
would our birds giggle	our birds would giggle QUEST	would
would her yaks giggle	her yaks would giggle QUEST	would
can the unicorn giggle	the unicorn can giggle QUEST	can
could our seals smile	our seals could smile QUEST	could
can some rabbits giggle	some rabbits can giggle QUEST	can
will my rabbits read	my rabbits will read QUEST	will
can our rabbits read	our rabbits can read QUEST	can
could some cats sleep	some cats could sleep QUEST	could
would our cats read	our cats would read QUEST	would
would some unicorn smile	some unicorn would smile QUEST	would
will our seals giggle	our seals will giggle QUEST	will
will our elephants read	our elephants will read QUEST	will
would her seal live	her seal would live QUEST	would
can her seal laugh	her seal can laugh QUEST	can
would my yak giggle	my yak would giggle QUEST	would
can our bird live	our bird can live QUEST	can
can her rabbit sleep	her rabbit can sleep QUEST	can